geneID,length,number_of_sites,order,site_start,site_end
YBR177C,40,3,1,229,269
YBR177C,30,3,2,906,936
YBR177C,45,3,3,1155,1200
YLR268W,30,1,1,443,473
YIR004W,32,1,1,1132,1164
YJL122W,119,3,1,329,448
YJL122W,15,3,2,468,483
YJL122W,17,3,3,486,503
YGR148C,36,1,1,261,297
YFR043C,17,3,1,296,313
YFR043C,19,3,2,318,337
YFR043C,55,3,3,458,513
YJL204C,41,2,1,427,468
YJL204C,23,2,2,794,817
YLR244C,34,10,1,243,277
YLR244C,76,10,2,392,468
YLR244C,41,10,3,461,502
YLR244C,52,10,4,596,648
YLR244C,112,10,5,704,816
YLR244C,51,10,6,887,938
YLR244C,75,10,7,979,1054
YLR244C,31,10,8,1056,1087
YLR244C,16,10,9,1110,1126
YLR244C,22,10,10,1142,1164
YNL003C,33,1,1,351,384
YBR160W,75,4,1,218,293
YBR160W,36,4,2,294,330
YBR160W,41,4,3,340,381
YBR160W,23,4,4,563,586
YJL082W,16,3,1,525,541
YJL082W,17,3,2,1502,1519
YJL082W,27,3,3,2117,2144
YHR007C,18,1,1,1336,1354
YLR197W,46,2,1,193,239
YLR197W,39,2,2,710,749
YKL190W,36,1,1,410,446
YDR312W,28,1,1,398,426
YLR348C,43,4,1,236,279
YLR348C,73,4,2,339,412
YLR348C,19,4,3,683,702
YLR348C,30,4,4,703,733
YBR248C,38,4,1,923,961
YBR248C,43,4,2,995,1038
YBR248C,30,4,3,1128,1158
YBR248C,33,4,4,1334,1367
YNL152W,33,2,1,229,262
YNL152W,43,2,2,441,484
YFL045C,88,2,1,262,350
YFL045C,59,2,2,597,656
YDR141C,18,4,1,320,338
YDR141C,26,4,2,459,485
YDR141C,20,4,3,818,838
YDR141C,20,4,4,3135,3155
YJL131C,29,1,1,868,897
YIL124W,19,6,1,259,278
YIL124W,114,6,2,287,401
YIL124W,19,6,3,512,531
YIL124W,24,6,4,532,556
YIL124W,52,6,5,724,776
YIL124W,31,6,6,863,894
YDR083W,31,2,1,697,728
YDR083W,15,2,2,1039,1054
YMR009W,29,1,1,347,376
YOR123C,38,3,1,646,684
YOR123C,23,3,2,968,991
YOR123C,29,3,3,1061,1090
YNL072W,29,4,1,441,470
YNL072W,32,4,2,489,521
YNL072W,18,4,3,569,587
YNL072W,26,4,4,603,629
YLR362W,28,3,1,503,531
YLR362W,23,3,2,639,662
YLR362W,17,3,3,1950,1967
YLR199C,19,5,1,308,327
YLR199C,16,5,2,392,408
YLR199C,28,5,3,476,504
YLR199C,16,5,4,675,691
YLR199C,55,5,5,755,810
YCL017C,60,15,1,197,257
YCL017C,25,15,2,272,297
YCL017C,15,15,3,303,318
YCL017C,53,15,4,342,395
YCL017C,149,15,5,410,559
YCL017C,38,15,6,563,601
YCL017C,29,15,7,624,653
YCL017C,23,15,8,675,698
YCL017C,25,15,9,704,729
YCL017C,20,15,10,776,796
YCL017C,24,15,11,831,855
YCL017C,68,15,12,867,935
YCL017C,48,15,13,960,1008
YCL017C,38,15,14,1207,1245
YCL017C,47,15,15,1266,1313
YIL108W,16,12,1,271,287
YIL108W,19,12,2,439,458
YIL108W,29,12,3,662,691
YIL108W,22,12,4,703,725
YIL108W,29,12,5,959,988
YIL108W,37,12,6,1123,1160
YIL108W,75,12,7,1504,1579
YIL108W,42,12,8,1583,1625
YIL108W,39,12,9,1663,1702
YIL108W,61,12,10,1777,1838
YIL108W,19,12,11,1864,1883
YIL108W,44,12,12,1933,1977
YBR273C,28,4,1,294,322
YBR273C,69,4,2,1059,1128
YBR273C,18,4,3,1129,1147
YBR273C,21,4,4,1158,1179
YHR025W,54,6,1,326,380
YHR025W,29,6,2,394,423
YHR025W,23,6,3,776,799
YHR025W,34,6,4,839,873
YHR025W,20,6,5,877,897
YHR025W,16,6,6,1036,1052
YHR009C,21,3,1,391,412
YHR009C,43,3,2,1224,1267
YHR009C,36,3,3,1477,1513
YLR447C,28,4,1,186,214
YLR447C,38,4,2,331,369
YLR447C,24,4,3,511,535
YLR447C,37,4,4,599,636
YOL058W,17,11,1,159,176
YOL058W,31,11,2,170,201
YOL058W,69,11,3,546,615
YOL058W,64,11,4,641,705
YOL058W,23,11,5,801,824
YOL058W,39,11,6,877,916
YOL058W,18,11,7,1046,1064
YOL058W,32,11,8,1058,1090
YOL058W,20,11,9,1095,1115
YOL058W,48,11,10,1116,1164
YOL058W,75,11,11,1188,1263
YIL062C,43,1,1,295,338
YNR032C-A,20,1,1,183,203
YOL129W,56,1,1,236,292
YOL116W,47,2,1,953,1000
YOL116W,39,2,2,1100,1139
YDL226C,40,2,1,926,966
YDL226C,40,2,2,953,993
YGL071W,39,5,1,458,497
YGL071W,22,5,2,521,543
YGL071W,18,5,3,546,564
YGL071W,21,5,4,796,817
YGL071W,20,5,5,1485,1505
YBR202W,27,8,1,752,779
YBR202W,38,8,2,1109,1147
YBR202W,58,8,3,1168,1226
YBR202W,27,8,4,1227,1254
YBR202W,47,8,5,1947,1994
YBR202W,42,8,6,2116,2158
YBR202W,25,8,7,2300,2325
YBR202W,65,8,8,2415,2480
YNL239W,55,2,1,346,401
YNL239W,40,2,2,1094,1134
YPL143W,26,1,1,271,297
YML105C,16,1,1,608,624
YNL288W,33,2,1,536,569
YNL288W,28,2,2,648,676
YIL091C,63,11,1,184,247
YIL091C,17,11,2,693,710
YIL091C,29,11,3,709,738
YIL091C,41,11,4,742,783
YIL091C,39,11,5,894,933
YIL091C,16,11,6,1138,1154
YIL091C,44,11,7,1141,1185
YIL091C,36,11,8,1297,1333
YIL091C,32,11,9,1653,1685
YIL091C,38,11,10,2025,2063
YIL091C,95,11,11,2070,2165
YOR048C,31,11,1,390,421
YOR048C,39,11,2,685,724
YOR048C,32,11,3,1034,1066
YOR048C,48,11,4,1926,1974
YOR048C,26,11,5,2012,2038
YOR048C,23,11,6,2060,2083
YOR048C,29,11,7,2150,2179
YOR048C,24,11,8,2426,2450
YOR048C,22,11,9,2573,2595
YOR048C,20,11,10,2940,2960
YOR048C,29,11,11,2992,3021
YNL103W,26,1,1,315,341
YAL046C,33,1,1,260,293
YAL039C,37,4,1,567,604
YAL039C,25,4,2,605,630
YAL039C,15,4,3,671,686
YAL039C,50,4,4,703,753
YNR018W,20,3,1,291,311
YNR018W,31,3,2,566,597
YNR018W,18,3,3,598,616
YNL168C,35,1,1,295,330
YCR034W,15,3,1,163,178
YCR034W,43,3,2,250,293
YCR034W,48,3,3,329,377
YFR047C,26,3,1,259,285
YFR047C,21,3,2,686,707
YFR047C,15,3,3,729,744
YBR215W,28,1,1,1613,1641
YIL106W,50,2,1,575,625
YIL106W,20,2,2,626,646
YNL240C,23,6,1,190,213
YNL240C,39,6,2,211,250
YNL240C,23,6,3,406,429
YNL240C,31,6,4,430,461
YNL240C,19,6,5,559,578
YNL240C,18,6,6,1060,1078
YML127W,18,6,1,661,679
YML127W,20,6,2,720,740
YML127W,33,6,3,926,959
YML127W,16,6,4,1148,1164
YML127W,24,6,5,1424,1448
YML127W,17,6,6,1650,1667
YCL030C,18,20,1,479,497
YCL030C,22,20,2,717,739
YCL030C,22,20,3,956,978
YCL030C,46,20,4,1110,1156
YCL030C,31,20,5,1149,1180
YCL030C,24,20,6,1260,1284
YCL030C,43,20,7,1291,1334
YCL030C,45,20,8,1364,1409
YCL030C,24,20,9,1411,1435
YCL030C,32,20,10,1426,1458
YCL030C,22,20,11,1475,1497
YCL030C,108,20,12,1539,1647
YCL030C,58,20,13,1656,1714
YCL030C,24,20,14,1717,1741
YCL030C,213,20,15,1754,1967
YCL030C,49,20,16,1968,2017
YCL030C,42,20,17,2018,2060
YCL030C,123,20,18,2062,2185
YCL030C,48,20,19,2176,2224
YCL030C,155,20,20,2231,2386
YGR084C,35,3,1,293,328
YGR084C,26,3,2,360,386
YGR084C,36,3,3,373,409
YDR286C,27,1,1,318,345
YDR399W,46,1,1,471,517
YHR141C,23,2,1,212,235
YHR141C,52,2,2,236,288
YLR355C,44,4,1,194,238
YLR355C,65,4,2,245,310
YLR355C,30,4,3,607,637
YLR355C,44,4,4,1134,1178
YGL157W,46,2,1,618,664
YGL157W,22,2,2,878,900
YPL128C,48,1,1,357,405
YOL090W,37,5,1,338,375
YOL090W,28,5,2,886,914
YOL090W,37,5,3,1135,1172
YOL090W,57,5,4,1170,1227
YOL090W,52,5,5,2023,2075
YLR300W,44,1,1,157,201
YMR195W,40,1,1,278,318
YGL100W,58,8,1,366,424
YGL100W,19,8,2,469,488
YGL100W,37,8,3,492,529
YGL100W,15,8,4,570,585
YGL100W,36,8,5,744,780
YGL100W,47,8,6,801,848
YGL100W,17,8,7,849,866
YGL100W,21,8,8,953,974
YBR094W,26,8,1,209,235
YBR094W,17,8,2,729,746
YBR094W,19,8,3,1183,1202
YBR094W,36,8,4,1709,1745
YBR094W,35,8,5,1895,1930
YBR094W,19,8,6,1977,1996
YBR094W,20,8,7,2077,2097
YBR094W,41,8,8,2178,2219
YHR112C,86,7,1,185,271
YHR112C,39,7,2,459,498
YHR112C,35,7,3,696,731
YHR112C,39,7,4,875,914
YHR112C,39,7,5,916,955
YHR112C,88,7,6,1002,1090
YHR112C,22,7,7,1091,1113
YDR035W,19,3,1,328,347
YDR035W,85,3,2,352,437
YDR035W,24,3,3,795,819
YHR106W,25,3,1,746,771
YHR106W,45,3,2,765,810
YHR106W,47,3,3,869,916
YLR011W,26,1,1,159,185
YIL044C,20,2,1,366,386
YIL044C,31,2,2,861,892
YPR183W,31,1,1,693,724
YOR206W,30,4,1,1041,1071
YOR206W,29,4,2,1494,1523
YOR206W,17,4,3,1778,1795
YOR206W,38,4,4,1909,1947
YBL042C,88,1,1,465,553
YCR046C,35,3,1,147,182
YCR046C,25,3,2,455,480
YCR046C,15,3,3,495,510
YLR059C,64,2,1,272,336
YLR059C,52,2,2,388,440
YDR507C,49,15,1,227,276
YDR507C,22,15,2,288,310
YDR507C,31,15,3,302,333
YDR507C,30,15,4,412,442
YDR507C,21,15,5,750,771
YDR507C,34,15,6,958,992
YDR507C,18,15,7,1026,1044
YDR507C,40,15,8,1627,1667
YDR507C,16,15,9,1685,1701
YDR507C,34,15,10,1703,1737
YDR507C,18,15,11,1739,1757
YDR507C,29,15,12,2226,2255
YDR507C,19,15,13,2619,2638
YDR507C,26,15,14,2812,2838
YDR507C,26,15,15,3320,3346
YEL007W,23,5,1,492,515
YEL007W,18,5,2,520,538
YEL007W,47,5,3,641,688
YEL007W,27,5,4,689,716
YEL007W,92,5,5,717,809
YNL217W,34,1,1,184,218
YKL204W,20,13,1,482,502
YKL204W,36,13,2,892,928
YKL204W,251,13,3,934,1185
YKL204W,40,13,4,1186,1226
YKL204W,43,13,5,1231,1274
YKL204W,105,13,6,1275,1380
YKL204W,155,13,7,1388,1543
YKL204W,84,13,8,1548,1632
YKL204W,39,13,9,1634,1673
YKL204W,114,13,10,1662,1776
YKL204W,48,13,11,1778,1826
YKL204W,43,13,12,1829,1872
YKL204W,26,13,13,1873,1899
YDL042C,26,1,1,840,866
YMR226C,41,1,1,371,412
YOR058C,40,3,1,2391,2431
YOR058C,20,3,2,2455,2475
YOR058C,34,3,3,2560,2594
YPL206C,41,3,1,531,572
YPL206C,46,3,2,750,796
YPL206C,36,3,3,783,819
YOL136C,16,5,1,526,542
YOL136C,21,5,2,544,565
YOL136C,38,5,3,652,690
YOL136C,18,5,4,1058,1076
YOL136C,20,5,5,1136,1156
YDL060W,18,9,1,521,539
YDL060W,53,9,2,1303,1356
YDL060W,53,9,3,1534,1587
YDL060W,30,9,4,1907,1937
YDL060W,24,9,5,1988,2012
YDL060W,32,9,6,2019,2051
YDL060W,42,9,7,2087,2129
YDL060W,22,9,8,2155,2177
YDL060W,30,9,9,2277,2307
YLR002C,50,1,1,706,756
YGL171W,32,7,1,398,430
YGL171W,30,7,2,948,978
YGL171W,25,7,3,1031,1056
YGL171W,22,7,4,1062,1084
YGL171W,45,7,5,1272,1317
YGL171W,28,7,6,1540,1568
YGL171W,89,7,7,1570,1659
YNR052C,15,6,1,180,195
YNR052C,26,6,2,200,226
YNR052C,16,6,3,228,244
YNR052C,33,6,4,231,264
YNR052C,19,6,5,637,656
YNR052C,19,6,6,674,693
YGR019W,114,12,1,254,368
YGR019W,67,12,2,387,454
YGR019W,20,12,3,482,502
YGR019W,72,12,4,581,653
YGR019W,29,12,5,748,777
YGR019W,24,12,6,822,846
YGR019W,29,12,7,969,998
YGR019W,56,12,8,1048,1104
YGR019W,37,12,9,1109,1146
YGR019W,19,12,10,1150,1169
YGR019W,18,12,11,1275,1293
YGR019W,52,12,12,1280,1332
YEL032W,53,13,1,251,304
YEL032W,33,13,2,291,324
YEL032W,90,13,3,689,779
YEL032W,32,13,4,786,818
YEL032W,33,13,5,806,839
YEL032W,22,13,6,1685,1707
YEL032W,22,13,7,2078,2100
YEL032W,29,13,8,2101,2130
YEL032W,27,13,9,2131,2158
YEL032W,37,13,10,2176,2213
YEL032W,40,13,11,2263,2303
YEL032W,41,13,12,2669,2710
YEL032W,28,13,13,2750,2778
YOL076W,44,10,1,258,302
YOL076W,30,10,2,656,686
YOL076W,35,10,3,688,723
YOL076W,79,10,4,765,844
YOL076W,19,10,5,1030,1049
YOL076W,19,10,6,1054,1073
YOL076W,30,10,7,1318,1348
YOL076W,16,10,8,1825,1841
YOL076W,19,10,9,2288,2307
YOL076W,31,10,10,2294,2325
YER110C,25,6,1,743,768
YER110C,25,6,2,1136,1161
YER110C,20,6,3,1321,1341
YER110C,41,6,4,1477,1518
YER110C,42,6,5,1882,1924
YER110C,19,6,6,2529,2548
YHR123W,28,1,1,228,256
YBL033C,67,5,1,246,313
YBL033C,82,5,2,316,398
YBL033C,18,5,3,486,504
YBL033C,41,5,4,872,913
YBL033C,24,5,5,955,979
YDR022C,22,1,1,181,203
YPL266W,20,4,1,277,297
YPL266W,19,4,2,430,449
YPL266W,60,4,3,638,698
YPL266W,37,4,4,774,811
YHR203C,39,2,1,304,343
YHR203C,25,2,2,536,561
YOR304W,16,5,1,2322,2338
YOR304W,16,5,2,2345,2361
YOR304W,31,5,3,2392,2423
YOR304W,35,5,4,2582,2617
YOR304W,28,5,5,3283,3311
YLR023C,15,3,1,205,220
YLR023C,30,3,2,644,674
YLR023C,24,3,3,845,869
YML112W,16,4,1,280,296
YML112W,28,4,2,368,396
YML112W,31,4,3,479,510
YML112W,29,4,4,537,566
YGL062W,24,15,1,830,854
YGL062W,33,15,2,906,939
YGL062W,51,15,3,968,1019
YGL062W,64,15,4,1641,1705
YGL062W,30,15,5,1714,1744
YGL062W,32,15,6,2387,2419
YGL062W,15,15,7,2539,2554
YGL062W,22,15,8,2657,2679
YGL062W,16,15,9,2680,2696
YGL062W,23,15,10,3037,3060
YGL062W,16,15,11,3112,3128
YGL062W,27,15,12,3136,3163
YGL062W,92,15,13,3164,3256
YGL062W,55,15,14,3332,3387
YGL062W,51,15,15,3449,3500
YER169W,41,7,1,329,370
YER169W,18,7,2,434,452
YER169W,19,7,3,469,488
YER169W,23,7,4,495,518
YER169W,26,7,5,1376,1402
YER169W,26,7,6,1431,1457
YER169W,17,7,7,1865,1882
YOL016C,77,1,1,917,994
YOR226C,35,1,1,436,471
YGL241W,39,1,1,356,395
YNL277W,45,6,1,530,575
YNL277W,34,6,2,1111,1145
YNL277W,35,6,3,1147,1182
YNL277W,16,6,4,1183,1199
YNL277W,44,6,5,1200,1244
YNL277W,26,6,6,1259,1285
YLR108C,15,7,1,343,358
YLR108C,27,7,2,455,482
YLR108C,50,7,3,739,789
YLR108C,18,7,4,797,815
YLR108C,25,7,5,1179,1204
YLR108C,37,7,6,1283,1320
YLR108C,16,7,7,1386,1402
YNL186W,30,7,1,145,175
YNL186W,19,7,2,176,195
YNL186W,15,7,3,1142,1157
YNL186W,35,7,4,1163,1198
YNL186W,30,7,5,1235,1265
YNL186W,35,7,6,1395,1430
YNL186W,27,7,7,2021,2048
YDR077W,44,2,1,771,815
YDR077W,41,2,2,976,1017
YCL044C,76,6,1,228,304
YCL044C,33,6,2,304,337
YCL044C,21,6,3,480,501
YCL044C,21,6,4,702,723
YCL044C,15,6,5,724,739
YCL044C,32,6,6,740,772
YKR008W,27,4,1,446,473
YKR008W,48,4,2,515,563
YKR008W,21,4,3,1637,1658
YKR008W,34,4,4,1774,1808
YMR146C,44,3,1,340,384
YMR146C,25,3,2,387,412
YMR146C,97,3,3,928,1025
YDR226W,31,1,1,472,503
YMR266W,31,1,1,2595,2626
YJL036W,54,1,1,860,914
YER009W,27,2,1,292,319
YER009W,17,2,2,328,345
YDL155W,22,4,1,682,704
YDL155W,29,4,2,739,768
YDL155W,15,4,3,769,784
YDL155W,31,4,4,817,848
YDR246W,26,1,1,489,515
YLR163C,31,6,1,729,760
YLR163C,24,6,2,762,786
YLR163C,18,6,3,912,930
YLR163C,53,6,4,1162,1215
YLR163C,29,6,5,1251,1280
YLR163C,22,6,6,1283,1305
YMR079W,54,5,1,332,386
YMR079W,95,5,2,486,581
YMR079W,35,5,3,568,603
YMR079W,144,5,4,640,784
YMR079W,31,5,5,796,827
YLR115W,32,5,1,251,283
YLR115W,15,5,2,386,401
YLR115W,24,5,3,1364,1388
YLR115W,17,5,4,1425,1442
YLR115W,22,5,5,2091,2113
YHR089C,58,2,1,523,581
YHR089C,16,2,2,597,613
YGL014W,15,14,1,809,824
YGL014W,56,14,2,1137,1193
YGL014W,32,14,3,1634,1666
YGL014W,57,14,4,1775,1832
YGL014W,36,14,5,1862,1898
YGL014W,49,14,6,1994,2043
YGL014W,39,14,7,2059,2098
YGL014W,22,14,8,2112,2134
YGL014W,26,14,9,2145,2171
YGL014W,33,14,10,2220,2253
YGL014W,81,14,11,2388,2469
YGL014W,21,14,12,2474,2495
YGL014W,27,14,13,2496,2523
YGL014W,29,14,14,2518,2547
YOR301W,18,2,1,195,213
YOR301W,27,2,2,337,364
YLL035W,64,2,1,600,664
YLL035W,29,2,2,1683,1712
YNL182C,26,11,1,263,289
YNL182C,29,11,2,609,638
YNL182C,20,11,3,750,770
YNL182C,52,11,4,762,814
YNL182C,22,11,5,815,837
YNL182C,31,11,6,1079,1110
YNL182C,15,11,7,1283,1298
YNL182C,36,11,8,1313,1349
YNL182C,18,11,9,1373,1391
YNL182C,31,11,10,1529,1560
YNL182C,36,11,11,1580,1616
YOR141C,43,13,1,335,378
YOR141C,15,13,2,786,801
YOR141C,33,13,3,1312,1345
YOR141C,34,13,4,1346,1380
YOR141C,99,13,5,1432,1531
YOR141C,43,13,6,1624,1667
YOR141C,62,13,7,1851,1913
YOR141C,15,13,8,1914,1929
YOR141C,29,13,9,2120,2149
YOR141C,21,13,10,2187,2208
YOR141C,30,13,11,2337,2367
YOR141C,27,13,12,2432,2459
YOR141C,18,13,13,2494,2512
YPR056W,18,2,1,644,662
YPR056W,52,2,2,953,1005
YER107C,25,9,1,315,340
YER107C,31,9,2,332,363
YER107C,62,9,3,366,428
YER107C,39,9,4,429,468
YER107C,21,9,5,469,490
YER107C,30,9,6,686,716
YER107C,40,9,7,825,865
YER107C,16,9,8,896,912
YER107C,18,9,9,1066,1084
YPL237W,17,1,1,646,663
YDL195W,35,14,1,555,590
YDL195W,87,14,2,757,844
YDL195W,37,14,3,834,871
YDL195W,40,14,4,1021,1061
YDL195W,24,14,5,1085,1109
YDL195W,42,14,6,1343,1385
YDL195W,27,14,7,1395,1422
YDL195W,32,14,8,1442,1474
YDL195W,43,14,9,1822,1865
YDL195W,56,14,10,2533,2589
YDL195W,18,14,11,2917,2935
YDL195W,22,14,12,2937,2959
YDL195W,19,14,13,2963,2982
YDL195W,38,14,14,3768,3806
YBR038W,75,22,1,200,275
YBR038W,43,22,2,358,401
YBR038W,54,22,3,407,461
YBR038W,27,22,4,527,554
YBR038W,26,22,5,558,584
YBR038W,40,22,6,781,821
YBR038W,21,22,7,827,848
YBR038W,15,22,8,1006,1021
YBR038W,21,22,9,1124,1145
YBR038W,42,22,10,1332,1374
YBR038W,17,22,11,1375,1392
YBR038W,30,22,12,1519,1549
YBR038W,22,22,13,1636,1658
YBR038W,55,22,14,1659,1714
YBR038W,44,22,15,1745,1789
YBR038W,41,22,16,1790,1831
YBR038W,16,22,17,1888,1904
YBR038W,32,22,18,2000,2032
YBR038W,21,22,19,2034,2055
YBR038W,20,22,20,2395,2415
YBR038W,33,22,21,2465,2498
YBR038W,16,22,22,2499,2515
YLR219W,16,7,1,651,667
YLR219W,18,7,2,669,687
YLR219W,29,7,3,956,985
YLR219W,26,7,4,1092,1118
YLR219W,46,7,5,1331,1377
YLR219W,17,7,6,1432,1449
YLR219W,18,7,7,1633,1651
YDR117C,31,6,1,303,334
YDR117C,33,6,2,632,665
YDR117C,34,6,3,652,686
YDR117C,40,6,4,1204,1244
YDR117C,46,6,5,1263,1309
YDR117C,27,6,6,1314,1341
YGR282C,19,1,1,306,325
YMR246W,39,9,1,220,259
YMR246W,22,9,2,346,368
YMR246W,16,9,3,424,440
YMR246W,16,9,4,667,683
YMR246W,43,9,5,685,728
YMR246W,30,9,6,731,761
YMR246W,18,9,7,1152,1170
YMR246W,65,9,8,1730,1795
YMR246W,175,9,9,1822,1997
YPL202C,75,4,1,300,375
YPL202C,39,4,2,377,416
YPL202C,57,4,3,417,474
YPL202C,33,4,4,492,525
YEL047C,21,1,1,1055,1076
YLR285W,92,3,1,268,360
YLR285W,21,3,2,365,386
YLR285W,24,3,3,745,769
YPR036W,27,4,1,467,494
YPR036W,19,4,2,604,623
YPR036W,48,4,3,672,720
YPR036W,47,4,4,1028,1075
YPR016C,17,4,1,354,371
YPR016C,44,4,2,375,419
YPR016C,52,4,3,449,501
YPR016C,34,4,4,618,652
YNL317W,20,9,1,437,457
YNL317W,32,9,2,589,621
YNL317W,51,9,3,847,898
YNL317W,22,9,4,903,925
YNL317W,20,9,5,954,974
YNL317W,23,9,6,1178,1201
YNL317W,36,9,7,1244,1280
YNL317W,30,9,8,1343,1373
YNL317W,18,9,9,1379,1397
YGR235C,28,2,1,351,379
YGR235C,26,2,2,540,566
YDL055C,30,5,1,188,218
YDL055C,18,5,2,273,291
YDL055C,57,5,3,399,456
YDL055C,16,5,4,1007,1023
YDL055C,34,5,5,1052,1086
YML072C,27,7,1,513,540
YML072C,26,7,2,567,593
YML072C,57,7,3,2229,2286
YML072C,27,7,4,3320,3347
YML072C,23,7,5,4188,4211
YML072C,16,7,6,4458,4474
YML072C,33,7,7,4461,4494
YHR052W,41,3,1,438,479
YHR052W,55,3,2,484,539
YHR052W,22,3,3,938,960
YKR026C,29,4,1,207,236
YKR026C,22,4,2,237,259
YKR026C,42,4,3,319,361
YKR026C,42,4,4,563,605
YFL044C,21,1,1,594,615
YJR043C,25,1,1,556,581
YJR012C,18,1,1,520,538
YJL130C,77,33,1,734,811
YJL130C,108,33,2,851,959
YJL130C,24,33,3,1146,1170
YJL130C,68,33,4,1324,1392
YJL130C,25,33,5,1517,1542
YJL130C,23,33,6,2257,2280
YJL130C,17,33,7,2303,2320
YJL130C,20,33,8,2322,2342
YJL130C,23,33,9,2353,2376
YJL130C,16,33,10,2412,2428
YJL130C,53,33,11,2458,2511
YJL130C,19,33,12,2513,2532
YJL130C,67,33,13,2595,2662
YJL130C,39,33,14,2738,2777
YJL130C,15,33,15,2801,2816
YJL130C,112,33,16,2914,3026
YJL130C,67,33,17,3123,3190
YJL130C,77,33,18,3528,3605
YJL130C,32,33,19,3641,3673
YJL130C,17,33,20,3978,3995
YJL130C,20,33,21,4433,4453
YJL130C,61,33,22,4552,4613
YJL130C,18,33,23,4731,4749
YJL130C,62,33,24,4765,4827
YJL130C,38,33,25,4950,4988
YJL130C,70,33,26,5115,5185
YJL130C,21,33,27,5193,5214
YJL130C,38,33,28,5603,5641
YJL130C,23,33,29,5900,5923
YJL130C,38,33,30,5934,5972
YJL130C,31,33,31,6080,6111
YJL130C,61,33,32,6362,6423
YJL130C,80,33,33,6528,6608
YNL173C,18,5,1,268,286
YNL173C,134,5,2,699,833
YNL173C,29,5,3,836,865
YNL173C,96,5,4,887,983
YNL173C,109,5,5,992,1101
YKL173W,35,5,1,716,751
YKL173W,34,5,2,1212,1246
YKL173W,28,5,3,1861,1889
YKL173W,16,5,4,1900,1916
YKL173W,92,5,5,2879,2971
YGR200C,17,15,1,224,241
YGR200C,153,15,2,297,450
YGR200C,36,15,3,468,504
YGR200C,16,15,4,747,763
YGR200C,87,15,5,780,867
YGR200C,20,15,6,869,889
YGR200C,52,15,7,890,942
YGR200C,34,15,8,1301,1335
YGR200C,31,15,9,1353,1384
YGR200C,34,15,10,1878,1912
YGR200C,51,15,11,1996,2047
YGR200C,48,15,12,2051,2099
YGR200C,87,15,13,2139,2226
YGR200C,71,15,14,2241,2312
YGR200C,17,15,15,2313,2330
YBR056W,28,8,1,241,269
YBR056W,33,8,2,271,304
YBR056W,22,8,3,481,503
YBR056W,32,8,4,516,548
YBR056W,44,8,5,590,634
YBR056W,20,8,6,743,763
YBR056W,32,8,7,959,991
YBR056W,33,8,8,1293,1326
YKL035W,30,9,1,369,399
YKL035W,58,9,2,433,491
YKL035W,22,9,3,524,546
YKL035W,21,9,4,557,578
YKL035W,87,9,5,653,740
YKL035W,70,9,6,746,816
YKL035W,55,9,7,962,1017
YKL035W,42,9,8,1044,1086
YKL035W,33,9,9,1264,1297
YIL127C,36,2,1,294,330
YIL127C,31,2,2,364,395
YDR348C,15,2,1,1298,1313
YDR348C,25,2,2,1446,1471
YKL182W,29,26,1,1396,1425
YKL182W,25,26,2,1427,1452
YKL182W,47,26,3,1590,1637
YKL182W,26,26,4,2129,2155
YKL182W,40,26,5,2398,2438
YKL182W,19,26,6,2738,2757
YKL182W,41,26,7,2758,2799
YKL182W,16,26,8,2845,2861
YKL182W,47,26,9,2941,2988
YKL182W,50,26,10,3172,3222
YKL182W,29,26,11,3618,3647
YKL182W,33,26,12,3742,3775
YKL182W,29,26,13,3925,3954
YKL182W,39,26,14,3945,3984
YKL182W,32,26,15,4017,4049
YKL182W,43,26,16,4458,4501
YKL182W,44,26,17,4531,4575
YKL182W,15,26,18,4668,4683
YKL182W,20,26,19,4905,4925
YKL182W,25,26,20,4936,4961
YKL182W,23,26,21,5113,5136
YKL182W,21,26,22,5357,5378
YKL182W,38,26,23,5611,5649
YKL182W,48,26,24,5751,5799
YKL182W,22,26,25,5866,5888
YKL182W,167,26,26,5972,6139
YDR469W,19,1,1,376,395
YDR333C,19,6,1,703,722
YDR333C,32,6,2,709,741
YDR333C,27,6,3,1386,1413
YDR333C,40,6,4,1539,1579
YDR333C,33,6,5,1815,1848
YDR333C,15,6,6,2055,2070
YNL160W,25,1,1,218,243
YLR223C,47,2,1,753,800
YLR223C,21,2,2,2502,2523
YIR012W,23,2,1,395,418
YIR012W,46,2,2,1142,1188
YLR363C,15,4,1,252,267
YLR363C,22,4,2,319,341
YLR363C,26,4,3,384,410
YLR363C,37,4,4,398,435
YGR049W,16,3,1,235,251
YGR049W,23,3,2,263,286
YGR049W,18,3,3,441,459
YNR026C,23,4,1,686,709
YNR026C,20,4,2,745,765
YNR026C,47,4,3,755,802
YNR026C,42,4,4,994,1036
YNR046W,19,2,1,170,189
YNR046W,39,2,2,224,263
YJL014W,43,9,1,250,293
YJL014W,31,9,2,308,339
YJL014W,77,9,3,431,508
YJL014W,47,9,4,710,757
YJL014W,82,9,5,968,1050
YJL014W,29,9,6,1052,1081
YJL014W,21,9,7,1082,1103
YJL014W,22,9,8,1287,1309
YJL014W,196,9,9,1409,1605
YKR046C,18,1,1,529,547
YJR005W,17,3,1,394,411
YJR005W,38,3,2,826,864
YJR005W,60,3,3,1590,1650
YMR031C,15,9,1,841,856
YMR031C,30,9,2,1251,1281
YMR031C,34,9,3,1733,1767
YMR031C,18,9,4,1773,1791
YMR031C,20,9,5,1792,1812
YMR031C,21,9,6,1877,1898
YMR031C,18,9,7,2055,2073
YMR031C,30,9,8,2065,2095
YMR031C,30,9,9,2448,2478
YKL183W,25,5,1,212,237
YKL183W,36,5,2,225,261
YKL183W,32,5,3,273,305
YKL183W,21,5,4,635,656
YKL183W,20,5,5,672,692
YBL098W,58,6,1,206,264
YBL098W,126,6,2,992,1118
YBL098W,19,6,3,1120,1139
YBL098W,32,6,4,1146,1178
YBL098W,19,6,5,1215,1234
YBL098W,31,6,6,1279,1310
YDL095W,162,1,1,185,347
YOR174W,25,2,1,250,275
YOR174W,33,2,2,262,295
YFL002C,45,7,1,498,543
YFL002C,18,7,2,795,813
YFL002C,24,7,3,909,933
YFL002C,27,7,4,940,967
YFL002C,26,7,5,1240,1266
YFL002C,21,7,6,1419,1440
YFL002C,24,7,7,1563,1587
YDR155C,36,2,1,173,209
YDR155C,67,2,2,212,279
YGL181W,37,1,1,428,465
YJR072C,24,3,1,261,285
YJR072C,19,3,2,597,616
YJR072C,38,3,3,957,995
YDR047W,20,6,1,321,341
YDR047W,26,6,2,342,368
YDR047W,18,6,3,632,650
YDR047W,18,6,4,812,830
YDR047W,39,6,5,940,979
YDR047W,24,6,6,1060,1084
YPL087W,29,1,1,218,247
YCR084C,31,23,1,588,619
YCR084C,25,23,2,623,648
YCR084C,59,23,3,738,797
YCR084C,15,23,4,812,827
YCR084C,38,23,5,815,853
YCR084C,30,23,6,918,948
YCR084C,79,23,7,962,1041
YCR084C,135,23,8,1042,1177
YCR084C,45,23,9,1178,1223
YCR084C,67,23,10,1235,1302
YCR084C,28,23,11,1311,1339
YCR084C,38,23,12,1347,1385
YCR084C,53,23,13,1390,1443
YCR084C,68,23,14,1432,1500
YCR084C,26,23,15,1531,1557
YCR084C,27,23,16,1596,1623
YCR084C,53,23,17,1631,1684
YCR084C,22,23,18,1685,1707
YCR084C,89,23,19,1738,1827
YCR084C,21,23,20,1832,1853
YCR084C,33,23,21,1854,1887
YCR084C,177,23,22,1901,2078
YCR084C,63,23,23,2079,2142
YJL054W,34,5,1,318,352
YJL054W,20,5,2,380,400
YJL054W,19,5,3,1112,1131
YJL054W,27,5,4,1361,1388
YJL054W,34,5,5,1380,1414
YOR118W,25,5,1,235,260
YOR118W,20,5,2,657,677
YOR118W,24,5,3,895,919
YOR118W,24,5,4,1115,1139
YOR118W,29,5,5,1127,1156
YPL170W,30,1,1,350,380
YML094W,26,3,1,414,440
YML094W,21,3,2,445,466
YML094W,34,3,3,453,487
YKR006C,52,10,1,168,220
YKR006C,77,10,2,244,321
YKR006C,20,10,3,324,344
YKR006C,22,10,4,403,425
YKR006C,37,10,5,426,463
YKR006C,23,10,6,510,533
YKR006C,15,10,7,627,642
YKR006C,55,10,8,659,714
YKR006C,21,10,9,716,737
YKR006C,42,10,10,750,792
YDL117W,27,7,1,187,214
YDL117W,37,7,2,201,238
YDL117W,33,7,3,457,490
YDL117W,29,7,4,1346,1375
YDL117W,19,7,5,2006,2025
YDL117W,20,7,6,2073,2093
YDL117W,20,7,7,2322,2342
YMR131C,21,3,1,1061,1082
YMR131C,44,3,2,1160,1204
YMR131C,15,3,3,1469,1484
YDR204W,29,3,1,192,221
YDR204W,22,3,2,675,697
YDR204W,25,3,3,943,968
YDR251W,33,4,1,414,447
YDR251W,22,4,2,449,471
YDR251W,31,4,3,715,746
YDR251W,15,4,4,2048,2063
YAL038W,73,10,1,263,336
YAL038W,16,10,2,545,561
YAL038W,66,10,3,626,692
YAL038W,28,10,4,833,861
YAL038W,43,10,5,958,1001
YAL038W,26,10,6,1123,1149
YAL038W,45,10,7,1150,1195
YAL038W,27,10,8,1197,1224
YAL038W,27,10,9,1397,1424
YAL038W,39,10,10,1429,1468
YOR074C,68,4,1,378,446
YOR074C,28,4,2,577,605
YOR074C,23,4,3,608,631
YOR074C,24,4,4,735,759
YNR019W,29,2,1,317,346
YNR019W,21,2,2,825,846
YGR158C,52,3,1,419,471
YGR158C,15,3,2,551,566
YGR158C,48,3,3,642,690
YKL077W,20,4,1,205,225
YKL077W,58,4,2,227,285
YKL077W,99,4,3,347,446
YKL077W,68,4,4,627,695
YBR212W,34,3,1,813,847
YBR212W,47,3,2,834,881
YBR212W,32,3,3,1308,1340
YJR109C,39,16,1,288,327
YJR109C,108,16,2,668,776
YJR109C,74,16,3,1071,1145
YJR109C,23,16,4,1701,1724
YJR109C,46,16,5,1744,1790
YJR109C,51,16,6,2118,2169
YJR109C,18,16,7,2172,2190
YJR109C,58,16,8,2316,2374
YJR109C,30,16,9,2403,2433
YJR109C,32,16,10,2473,2505
YJR109C,20,16,11,2506,2526
YJR109C,43,16,12,2545,2588
YJR109C,15,16,13,2713,2728
YJR109C,17,16,14,2729,2746
YJR109C,81,16,15,2772,2853
YJR109C,39,16,16,3225,3264
YKL025C,24,2,1,978,1002
YKL025C,17,2,2,1003,1020
YBR158W,28,8,1,237,265
YBR158W,27,8,2,503,530
YBR158W,16,8,3,964,980
YBR158W,25,8,4,1023,1048
YBR158W,37,8,5,1115,1152
YBR158W,22,8,6,1480,1502
YBR158W,28,8,7,1503,1531
YBR158W,82,8,8,1555,1637
YPL105C,41,4,1,172,213
YPL105C,16,4,2,216,232
YPL105C,16,4,3,704,720
YPL105C,15,4,4,729,744
YOL097C,22,1,1,370,392
YJL096W,40,1,1,346,386
YLR354C,34,2,1,463,497
YLR354C,26,2,2,687,713
YNR020C,15,2,1,705,720
YNR020C,38,2,2,735,773
YLR301W,49,2,1,221,270
YLR301W,22,2,2,619,641
YPL129W,62,1,1,204,266
YOR264W,16,9,1,454,470
YOR264W,19,9,2,477,496
YOR264W,26,9,3,497,523
YOR264W,25,9,4,539,564
YOR264W,16,9,5,592,608
YOR264W,29,9,6,637,666
YOR264W,18,9,7,677,695
YOR264W,29,9,8,715,744
YOR264W,30,9,9,1195,1225
YNL241C,57,5,1,303,360
YNL241C,32,5,2,538,570
YNL241C,16,5,3,1102,1118
YNL241C,16,5,4,1145,1161
YNL241C,23,5,5,1187,1210
YJL154C,59,12,1,348,407
YJL154C,24,12,2,408,432
YJL154C,18,12,3,537,555
YJL154C,29,12,4,685,714
YJL154C,33,12,5,751,784
YJL154C,18,12,6,827,845
YJL154C,22,12,7,1944,1966
YJL154C,15,12,8,1971,1986
YJL154C,21,12,9,2067,2088
YJL154C,34,12,10,2280,2314
YJL154C,33,12,11,2317,2350
YJL154C,32,12,12,2572,2604
YDR091C,18,21,1,171,189
YDR091C,36,21,2,215,251
YDR091C,16,21,3,446,462
YDR091C,97,21,4,468,565
YDR091C,24,21,5,588,612
YDR091C,78,21,6,615,693
YDR091C,95,21,7,695,790
YDR091C,49,21,8,941,990
YDR091C,20,21,9,999,1019
YDR091C,33,21,10,1008,1041
YDR091C,37,21,11,1076,1113
YDR091C,18,21,12,1114,1132
YDR091C,55,21,13,1121,1176
YDR091C,28,21,14,1179,1207
YDR091C,17,21,15,1293,1310
YDR091C,20,21,16,1329,1349
YDR091C,15,21,17,1369,1384
YDR091C,33,21,18,1390,1423
YDR091C,73,21,19,1451,1524
YDR091C,41,21,20,1546,1587
YDR091C,37,21,21,1662,1699
YJL123C,55,3,1,1067,1122
YJL123C,21,3,2,1250,1271
YJL123C,27,3,3,1308,1335
YHR066W,47,2,1,291,338
YHR066W,22,2,2,340,362
YPL188W,18,4,1,182,200
YPL188W,55,4,2,221,276
YPL188W,35,4,3,744,779
YPL188W,59,4,4,1026,1085
YBR011C,89,3,1,533,622
YBR011C,30,3,2,623,653
YBR011C,46,3,3,684,730
YBR129C,54,2,1,322,376
YBR129C,49,2,2,401,450
YDL160C,34,3,1,363,397
YDL160C,63,3,2,451,514
YDL160C,37,3,3,732,769
YBR176W,44,3,1,173,217
YBR176W,26,3,2,224,250
YBR176W,53,3,3,259,312
YPL173W,100,3,1,588,688
YPL173W,75,3,2,685,760
YPL173W,18,3,3,818,836
YDL215C,20,8,1,447,467
YDL215C,16,8,2,470,486
YDL215C,15,8,3,2319,2334
YDL215C,17,8,4,2349,2366
YDL215C,31,8,5,2769,2800
YDL215C,20,8,6,2860,2880
YDL215C,30,8,7,2867,2897
YDL215C,15,8,8,3007,3022
YKL099C,21,2,1,318,339
YKL099C,18,2,2,686,704
YJL143W,144,2,1,272,416
YJL143W,19,2,2,422,441
YGL238W,27,7,1,396,423
YGL238W,25,7,2,754,779
YGL238W,53,7,3,932,985
YGL238W,36,7,4,1877,1913
YGL238W,26,7,5,1951,1977
YGL238W,59,7,6,2147,2206
YGL238W,47,7,7,2369,2416
YKL029C,28,19,1,198,226
YKL029C,75,19,2,232,307
YKL029C,35,19,3,359,394
YKL029C,19,19,4,400,419
YKL029C,19,19,5,425,444
YKL029C,23,19,6,464,487
YKL029C,24,19,7,585,609
YKL029C,46,19,8,610,656
YKL029C,54,19,9,708,762
YKL029C,90,19,10,767,857
YKL029C,16,19,11,973,989
YKL029C,42,19,12,1041,1083
YKL029C,23,19,13,1097,1120
YKL029C,32,19,14,1135,1167
YKL029C,29,19,15,1504,1533
YKL029C,98,19,16,1629,1727
YKL029C,19,19,17,1818,1837
YKL029C,32,19,18,1908,1940
YKL029C,21,19,19,1949,1970
YNL104C,47,10,1,248,295
YNL104C,39,10,2,338,377
YNL104C,43,10,3,503,546
YNL104C,18,10,4,551,569
YNL104C,40,10,5,600,640
YNL104C,20,10,6,796,816
YNL104C,20,10,7,1184,1204
YNL104C,48,10,8,1232,1280
YNL104C,21,10,9,1423,1444
YNL104C,16,10,10,1801,1817
YPL145C,37,4,1,605,642
YPL145C,54,4,2,696,750
YPL145C,79,4,3,857,936
YPL145C,87,4,4,1017,1104
YIL118W,15,3,1,496,511
YIL118W,35,3,2,504,539
YIL118W,26,3,3,627,653
YNL151C,20,2,1,615,635
YNL151C,63,2,2,636,699
YPL190C,29,5,1,1039,1068
YPL190C,26,5,2,1509,1535
YPL190C,32,5,3,1596,1628
YPL190C,27,5,4,1809,1836
YPL190C,36,5,5,1823,1859
YKL191W,41,6,1,402,443
YKL191W,30,6,2,536,566
YKL191W,55,6,3,644,699
YKL191W,29,6,4,757,786
YKL191W,29,6,5,917,946
YKL191W,26,6,6,1517,1543
YNR006W,15,3,1,269,284
YNR006W,32,3,2,288,320
YNR006W,19,3,3,729,748
YOR023C,39,7,1,232,271
YOR023C,31,7,2,330,361
YOR023C,24,7,3,640,664
YOR023C,40,7,4,684,724
YOR023C,33,7,5,795,828
YOR023C,15,7,6,1353,1368
YOR023C,41,7,7,1475,1516
YFR005C,29,5,1,767,796
YFR005C,46,5,2,946,992
YFR005C,15,5,3,1182,1197
YFR005C,19,5,4,1204,1223
YFR005C,57,5,5,1275,1332
YOR267C,23,11,1,183,206
YOR267C,54,11,2,867,921
YOR267C,37,11,3,941,978
YOR267C,36,11,4,986,1022
YOR267C,34,11,5,1016,1050
YOR267C,23,11,6,1068,1091
YOR267C,28,11,7,1226,1254
YOR267C,26,11,8,1332,1358
YOR267C,15,11,9,1367,1382
YOR267C,33,11,10,1377,1410
YOR267C,21,11,11,2253,2274
YOR357C,28,1,1,372,400
YDR530C,33,1,1,249,282
YEL031W,36,2,1,203,239
YEL031W,79,2,2,240,319
YNR053C,17,11,1,258,275
YNR053C,27,11,2,276,303
YNR053C,58,11,3,357,415
YNR053C,57,11,4,437,494
YNR053C,19,11,5,636,655
YNR053C,30,11,6,857,887
YNR053C,21,11,7,894,915
YNR053C,30,11,8,1148,1178
YNR053C,16,11,9,1184,1200
YNR053C,63,11,10,1201,1264
YNR053C,55,11,11,1331,1386
YDL063C,24,3,1,381,405
YDL063C,42,3,2,1122,1164
YDL063C,38,3,3,1410,1448
YOR367W,28,2,1,220,248
YOR367W,56,2,2,300,356
YOR385W,21,2,1,533,554
YOR385W,33,2,2,693,726
YGR185C,27,4,1,336,363
YGR185C,48,4,2,423,471
YGR185C,18,4,3,951,969
YGR185C,24,4,4,1030,1054
YER168C,17,1,1,1400,1417
YIL083C,23,4,1,315,338
YIL083C,52,4,2,496,548
YIL083C,28,4,3,747,775
YIL083C,36,4,4,793,829
YOR081C,15,2,1,1427,1442
YOR081C,15,2,2,2166,2181
YCL014W,25,13,1,355,380
YCL014W,31,13,2,843,874
YCL014W,15,13,3,998,1013
YCL014W,37,13,4,1000,1037
YCL014W,21,13,5,1038,1059
YCL014W,15,13,6,1066,1081
YCL014W,16,13,7,1177,1193
YCL014W,20,13,8,1222,1242
YCL014W,33,13,9,1712,1745
YCL014W,16,13,10,2041,2057
YCL014W,17,13,11,2372,2389
YCL014W,30,13,12,2574,2604
YCL014W,26,13,13,2855,2881
YGL172W,68,5,1,884,952
YGL172W,22,5,2,958,980
YGL172W,15,5,3,1168,1183
YGL172W,20,5,4,1283,1303
YGL172W,30,5,5,1335,1365
YNL274C,44,3,1,372,416
YNL274C,23,3,2,418,441
YNL274C,17,3,3,668,685
YIL096C,37,2,1,316,353
YIL096C,27,2,2,469,496
YDR021W,28,1,1,1013,1041
YHL011C,106,3,1,165,271
YHL011C,29,3,2,414,443
YHL011C,18,3,3,447,465
YPL212C,60,6,1,222,282
YPL212C,20,6,2,310,330
YPL212C,44,6,3,1099,1143
YPL212C,15,6,4,1343,1358
YPL212C,26,6,5,1534,1560
YPL212C,29,6,6,1579,1608
YMR296C,20,3,1,263,283
YMR296C,16,3,2,780,796
YMR296C,27,3,3,1574,1601
YGR184C,22,21,1,291,313
YGR184C,32,21,2,315,347
YGR184C,27,21,3,1305,1332
YGR184C,56,21,4,1333,1389
YGR184C,16,21,5,1440,1456
YGR184C,31,21,6,1835,1866
YGR184C,15,21,7,1963,1978
YGR184C,36,21,8,2006,2042
YGR184C,21,21,9,2077,2098
YGR184C,60,21,10,2103,2163
YGR184C,31,21,11,4046,4077
YGR184C,50,21,12,4106,4156
YGR184C,20,21,13,4210,4230
YGR184C,15,21,14,4300,4315
YGR184C,41,21,15,4471,4512
YGR184C,32,21,16,4638,4670
YGR184C,46,21,17,4868,4914
YGR184C,25,21,18,5205,5230
YGR184C,31,21,19,5275,5306
YGR184C,24,21,20,5366,5390
YGR184C,15,21,21,5506,5521
YLR330W,16,2,1,408,424
YLR330W,115,2,2,415,530
YOR310C,49,3,1,473,522
YOR310C,54,3,2,669,723
YOR310C,97,3,3,1349,1446
YFR051C,17,3,1,379,396
YFR051C,23,3,2,1176,1199
YFR051C,25,3,3,1249,1274
YHR024C,47,9,1,837,884
YHR024C,43,9,2,1034,1077
YHR024C,20,9,3,1078,1098
YHR024C,16,9,4,1127,1143
YHR024C,32,9,5,1131,1163
YHR024C,20,9,6,1169,1189
YHR024C,16,9,7,1209,1225
YHR024C,28,9,8,1241,1269
YHR024C,38,9,9,1292,1330
YDR188W,66,3,1,787,853
YDR188W,25,3,2,976,1001
YDR188W,92,3,3,1260,1352
YER090W,73,8,1,517,590
YER090W,34,8,2,727,761
YER090W,16,8,3,963,979
YER090W,22,8,4,1033,1055
YER090W,45,8,5,1186,1231
YER090W,22,8,6,1252,1274
YER090W,22,8,7,1396,1418
YER090W,50,8,8,1465,1515
YOL057W,16,5,1,928,944
YOL057W,51,5,2,1046,1097
YOL057W,29,5,3,1196,1225
YOL057W,24,5,4,1565,1589
YOL057W,41,5,5,1997,2038
YFR004W,16,1,1,573,589
YDR017C,15,20,1,648,663
YDR017C,34,20,2,687,721
YDR017C,45,20,3,893,938
YDR017C,41,20,4,942,983
YDR017C,44,20,5,1003,1047
YDR017C,28,20,6,1085,1113
YDR017C,42,20,7,1115,1157
YDR017C,15,20,8,1221,1236
YDR017C,21,20,9,1238,1259
YDR017C,47,20,10,1263,1310
YDR017C,20,20,11,1524,1544
YDR017C,20,20,12,2029,2049
YDR017C,26,20,13,2098,2124
YDR017C,23,20,14,2143,2166
YDR017C,30,20,15,2344,2374
YDR017C,22,20,16,2422,2444
YDR017C,23,20,17,2637,2660
YDR017C,15,20,18,2736,2751
YDR017C,31,20,19,2751,2782
YDR017C,19,20,20,3007,3026
YMR303C,65,2,1,300,365
YMR303C,22,2,2,539,561
YOR369C,56,2,1,216,272
YOR369C,42,2,2,362,404
YOR086C,17,5,1,1093,1110
YOR086C,22,5,2,1501,1523
YOR086C,42,5,3,1770,1812
YOR086C,19,5,4,2275,2294
YOR086C,21,5,5,2295,2316
YNR033W,15,15,1,911,926
YNR033W,20,15,2,930,950
YNR033W,19,15,3,957,976
YNR033W,17,15,4,986,1003
YNR033W,30,15,5,1073,1103
YNR033W,30,15,6,1261,1291
YNR033W,34,15,7,1528,1562
YNR033W,24,15,8,1700,1724
YNR033W,32,15,9,1725,1757
YNR033W,17,15,10,1814,1831
YNR033W,29,15,11,1862,1891
YNR033W,25,15,12,1910,1935
YNR033W,29,15,13,2058,2087
YNR033W,34,15,14,2083,2117
YNR033W,29,15,15,2133,2162
YMR186W,53,8,1,528,581
YMR186W,45,8,2,675,720
YMR186W,49,8,3,721,770
YMR186W,160,8,4,1049,1209
YMR186W,19,8,5,1216,1235
YMR186W,56,8,6,1475,1531
YMR186W,42,8,7,1626,1668
YMR186W,42,8,8,1976,2018
YDR195W,18,4,1,809,827
YDR195W,22,4,2,1341,1363
YDR195W,22,4,3,1398,1420
YDR195W,30,4,4,1415,1445
YNL256W,37,11,1,378,415
YNL256W,18,11,2,416,434
YNL256W,49,11,3,633,682
YNL256W,18,11,4,684,702
YNL256W,15,11,5,889,904
YNL256W,15,11,6,907,922
YNL256W,24,11,7,931,955
YNL256W,33,11,8,1117,1150
YNL256W,32,11,9,1141,1173
YNL256W,19,11,10,1743,1762
YNL256W,27,11,11,2253,2280
YMR278W,60,7,1,244,304
YMR278W,19,7,2,869,888
YMR278W,19,7,3,968,987
YMR278W,35,7,4,1369,1404
YMR278W,18,7,5,1486,1504
YMR278W,35,7,6,1784,1819
YMR278W,31,7,7,1813,1844
YLR136C,29,1,1,359,388
YOR197W,92,3,1,701,793
YOR197W,30,3,2,923,953
YOR197W,39,3,3,941,980
YKR089C,21,4,1,279,300
YKR089C,45,4,2,812,857
YKR089C,21,4,3,1687,1708
YKR089C,24,4,4,1713,1737
YPR057W,33,2,1,436,469
YPR057W,40,2,2,533,573
YCR027C,16,1,1,241,257
YBL107C,50,1,1,355,405
YPR094W,23,1,1,239,262
YDR116C,16,2,1,287,303
YDR116C,67,2,2,492,559
YLR325C,23,2,1,164,187
YLR325C,46,2,2,191,237
YMR110C,33,7,1,435,468
YMR110C,24,7,2,823,847
YMR110C,23,7,3,1130,1153
YMR110C,48,7,4,1161,1209
YMR110C,49,7,5,1205,1254
YMR110C,36,7,6,1255,1291
YMR110C,26,7,7,1318,1344
YDL056W,15,5,1,1132,1147
YDL056W,19,5,2,1167,1186
YDL056W,30,5,3,1211,1241
YDL056W,22,5,4,1574,1596
YDL056W,35,5,5,2115,2150
YGR234W,24,6,1,350,374
YGR234W,18,6,2,424,442
YGR234W,43,6,3,634,677
YGR234W,33,6,4,730,763
YGR234W,19,6,5,824,843
YGR234W,32,6,6,1030,1062
YMR178W,37,3,1,301,338
YMR178W,54,3,2,387,441
YMR178W,64,3,3,700,764
YGL115W,22,1,1,683,705
YOR094W,21,1,1,221,242
YMR247C,31,4,1,791,822
YMR247C,60,4,2,2181,2241
YMR247C,17,4,3,2646,2663
YMR247C,35,4,4,4402,4437
YPR037C,41,2,1,402,443
YPR037C,35,2,2,511,546
YML071C,27,3,1,269,296
YML071C,35,3,2,634,669
YML071C,23,3,3,819,842
YBR077C,76,2,1,197,273
YBR077C,44,2,2,434,478
YDR122W,16,10,1,646,662
YDR122W,15,10,2,670,685
YDR122W,15,10,3,864,879
YDR122W,28,10,4,1053,1081
YDR122W,35,10,5,1085,1120
YDR122W,19,10,6,1131,1150
YDR122W,27,10,7,1275,1302
YDR122W,23,10,8,1308,1331
YDR122W,34,10,9,1661,1695
YDR122W,34,10,10,2844,2878
YER120W,78,3,1,251,329
YER120W,57,3,2,363,420
YER120W,55,3,3,467,522
YNL090W,22,2,1,464,486
YNL090W,43,2,2,476,519
YOL062C,24,4,1,1037,1061
YOL062C,22,4,2,1208,1230
YOL062C,31,4,3,1246,1277
YOL062C,15,4,4,1296,1311
YDR381W,17,1,1,443,460
YOR207C,116,18,1,464,580
YOR207C,59,18,2,588,647
YOR207C,31,18,3,869,900
YOR207C,34,18,4,1835,1869
YOR207C,41,18,5,1920,1961
YOR207C,36,18,6,1983,2019
YOR207C,53,18,7,2028,2081
YOR207C,30,18,8,2103,2133
YOR207C,33,18,9,2256,2289
YOR207C,56,18,10,2403,2459
YOR207C,46,18,11,2468,2514
YOR207C,19,18,12,2524,2543
YOR207C,22,18,13,2581,2603
YOR207C,27,18,14,2771,2798
YOR207C,27,18,15,3222,3249
YOR207C,36,18,16,3245,3281
YOR207C,18,18,17,3319,3337
YOR207C,15,18,18,3360,3375
YMR225C,28,1,1,269,297
YOR370C,22,7,1,224,246
YOR370C,68,7,2,453,521
YOR370C,15,7,3,585,600
YOR370C,22,7,4,1195,1217
YOR370C,40,7,5,1218,1258
YOR370C,29,7,6,1267,1296
YOR370C,30,7,7,1541,1571
YGR192C,35,4,1,236,271
YGR192C,16,4,2,272,288
YGR192C,26,4,3,608,634
YGR192C,18,4,4,974,992
YHR111W,52,7,1,323,375
YHR111W,31,7,2,376,407
YHR111W,45,7,3,418,463
YHR111W,164,7,4,496,660
YHR111W,124,7,5,778,902
YHR111W,36,7,6,910,946
YHR111W,16,7,7,1180,1196
YBL045C,33,4,1,551,584
YBL045C,78,4,2,865,943
YBL045C,45,4,3,970,1015
YBL045C,32,4,4,1263,1295
YGL178W,28,2,1,869,897
YGL178W,58,2,2,1465,1523
YDL070W,89,2,1,574,663
YDL070W,19,2,2,666,685
YGL185C,31,3,1,469,500
YGL185C,39,3,2,869,908
YGL185C,19,3,3,1041,1060
YCR047C,37,1,1,572,609
YER064C,58,2,1,227,285
YER064C,20,2,2,1429,1449
YOR241W,21,7,1,625,646
YOR241W,23,7,2,1294,1317
YOR241W,35,7,3,1329,1364
YOR241W,15,7,4,1399,1414
YOR241W,27,7,5,1505,1532
YOR241W,17,7,6,1602,1619
YOR241W,23,7,7,1622,1645
YLL021W,51,18,1,621,672
YLL021W,21,18,2,673,694
YLL021W,20,18,3,696,716
YLL021W,15,18,4,1874,1889
YLL021W,17,18,5,1904,1921
YLL021W,43,18,6,2073,2116
YLL021W,58,18,7,2256,2314
YLL021W,22,18,8,2357,2379
YLL021W,30,18,9,2725,2755
YLL021W,27,18,10,2863,2890
YLL021W,20,18,11,2899,2919
YLL021W,46,18,12,2924,2970
YLL021W,45,18,13,3476,3521
YLL021W,50,18,14,3737,3787
YLL021W,20,18,15,3870,3890
YLL021W,21,18,16,4276,4297
YLL021W,42,18,17,4317,4359
YLL021W,34,18,18,4361,4395
YKL205W,22,10,1,382,404
YKL205W,35,10,2,1106,1141
YKL205W,36,10,3,1280,1316
YKL205W,20,10,4,1468,1488
YKL205W,40,10,5,1936,1976
YKL205W,22,10,6,1979,2001
YKL205W,15,10,7,2861,2876
YKL205W,22,10,8,2896,2918
YKL205W,24,10,9,3182,3206
YKL205W,18,10,10,3213,3231
YBR088C,34,3,1,486,520
YBR088C,67,3,2,657,724
YBR088C,32,3,3,725,757
YBR055C,18,2,1,1101,1119
YBR055C,15,2,2,2330,2345
YFL005W,78,4,1,221,299
YFL005W,63,4,2,325,388
YFL005W,43,4,3,461,504
YFL005W,18,4,4,568,586
YKL110C,48,4,1,195,243
YKL110C,51,4,2,434,485
YKL110C,21,4,3,625,646
YKL110C,45,4,4,768,813
YPR040W,22,2,1,950,972
YPR040W,57,2,2,987,1044
YHR040W,33,2,1,464,497
YHR040W,31,2,2,841,872
YMR152W,58,8,1,206,264
YMR152W,63,8,2,290,353
YMR152W,74,8,3,585,659
YMR152W,34,8,4,781,815
YMR152W,15,8,5,826,841
YMR152W,26,8,6,916,942
YMR152W,25,8,7,965,990
YMR152W,62,8,8,996,1058
YML057W,21,3,1,707,728
YML057W,74,3,2,733,807
YML057W,18,3,3,1380,1398
YDR178W,54,1,1,458,512
YKR038C,20,5,1,376,396
YKR038C,90,5,2,582,672
YKR038C,23,5,3,675,698
YKR038C,18,5,4,1023,1041
YKR038C,21,5,5,1113,1134
YLR432W,27,9,1,167,194
YLR432W,23,9,2,271,294
YLR432W,20,9,3,303,323
YLR432W,39,9,4,467,506
YLR432W,21,9,5,612,633
YLR432W,44,9,6,932,976
YLR432W,49,9,7,1210,1259
YLR432W,41,9,8,1359,1400
YLR432W,90,9,9,1482,1572
YMR029C,18,6,1,315,333
YMR029C,15,6,2,801,816
YMR029C,18,6,3,886,904
YMR029C,22,6,4,1054,1076
YMR029C,23,6,5,1106,1129
YMR029C,31,6,6,1403,1434
YGL004C,21,1,1,747,768
YML097C,36,1,1,211,247
YPR102C,96,1,1,351,447
YHR193C,72,1,1,239,311
YBL099W,59,7,1,185,244
YBL099W,36,7,2,248,284
YBL099W,37,7,3,602,639
YBL099W,22,7,4,667,689
YBL099W,25,7,5,879,904
YBL099W,43,7,6,1067,1110
YBL099W,41,7,7,1156,1197
YMR132C,21,1,1,210,231
YPL064C,38,3,1,187,225
YPL064C,53,3,2,226,279
YPL064C,17,3,3,610,627
YDL116W,53,4,1,548,601
YDL116W,43,4,2,643,686
YDL116W,17,4,3,1145,1162
YDL116W,18,4,4,1759,1777
YPL184C,23,5,1,775,798
YPL184C,18,5,2,822,840
YPL184C,31,5,3,888,919
YPL184C,19,5,4,1187,1206
YPL184C,22,5,5,1255,1277
YOR119C,76,4,1,487,563
YOR119C,26,4,2,623,649
YOR119C,39,4,3,1076,1115
YOR119C,29,4,4,1214,1243
YOR165W,77,4,1,280,357
YOR165W,18,4,2,1024,1042
YOR165W,66,4,3,1136,1202
YOR165W,32,4,4,1709,1741
YDR054C,19,2,1,408,427
YDR054C,17,2,2,429,446
YLR409C,20,10,1,537,557
YLR409C,48,10,2,973,1021
YLR409C,16,10,3,1568,1584
YLR409C,53,10,4,1739,1792
YLR409C,27,10,5,1893,1920
YLR409C,26,10,6,2024,2050
YLR409C,30,10,7,2120,2150
YLR409C,29,10,8,2349,2378
YLR409C,24,10,9,2377,2401
YLR409C,60,10,10,2556,2616
YNL316C,48,3,1,283,331
YNL316C,23,3,2,375,398
YNL316C,32,3,3,713,745
YCL045C,23,1,1,190,213
YKR065C,33,4,1,155,188
YKR065C,61,4,2,201,262
YKR065C,114,4,3,266,380
YKR065C,16,4,4,403,419
YPR171W,27,10,1,277,304
YPR171W,29,10,2,587,616
YPR171W,15,10,3,702,717
YPR171W,28,10,4,907,935
YPR171W,26,10,5,1017,1043
YPR171W,18,10,6,1070,1088
YPR171W,20,10,7,1159,1179
YPR171W,19,10,8,1286,1305
YPR171W,34,10,9,1326,1360
YPR171W,15,10,10,1523,1538
YLL040C,38,33,1,228,266
YLL040C,15,33,2,610,625
YLL040C,19,33,3,626,645
YLL040C,21,33,4,1249,1270
YLL040C,34,33,5,1270,1304
YLL040C,16,33,6,1713,1729
YLL040C,23,33,7,2595,2618
YLL040C,30,33,8,2754,2784
YLL040C,33,33,9,2977,3010
YLL040C,15,33,10,3713,3728
YLL040C,18,33,11,3738,3756
YLL040C,19,33,12,5114,5133
YLL040C,28,33,13,6069,6097
YLL040C,63,33,14,6084,6147
YLL040C,58,33,15,6154,6212
YLL040C,40,33,16,6217,6257
YLL040C,23,33,17,6768,6791
YLL040C,32,33,18,6915,6947
YLL040C,30,33,19,6948,6978
YLL040C,23,33,20,7083,7106
YLL040C,44,33,21,7402,7446
YLL040C,42,33,22,7536,7578
YLL040C,40,33,23,7574,7614
YLL040C,47,33,24,7623,7670
YLL040C,21,33,25,7679,7700
YLL040C,16,33,26,7715,7731
YLL040C,32,33,27,7724,7756
YLL040C,19,33,28,8160,8179
YLL040C,38,33,29,8181,8219
YLL040C,40,33,30,8373,8413
YLL040C,71,33,31,9159,9230
YLL040C,15,33,32,9231,9246
YLL040C,30,33,33,9254,9284
YKL103C,31,4,1,360,391
YKL103C,17,4,2,557,574
YKL103C,56,4,3,603,659
YKL103C,52,4,4,1465,1517
YMR109W,36,12,1,788,824
YMR109W,16,12,2,1022,1038
YMR109W,30,12,3,1100,1130
YMR109W,40,12,4,1679,1719
YMR109W,20,12,5,1973,1993
YMR109W,17,12,6,2016,2033
YMR109W,17,12,7,2057,2074
YMR109W,40,12,8,2189,2229
YMR109W,22,12,9,2564,2586
YMR109W,18,12,10,2729,2747
YMR109W,18,12,11,2781,2799
YMR109W,32,12,12,2979,3011
YLR094C,16,5,1,912,928
YLR094C,42,5,2,930,972
YLR094C,96,5,3,1143,1239
YLR094C,15,5,4,1347,1362
YLR094C,24,5,5,1485,1509
YBR037C,18,5,1,235,253
YBR037C,15,5,2,295,310
YBR037C,33,5,3,309,342
YBR037C,20,5,4,767,787
YBR037C,17,5,5,789,806
YDR232W,25,5,1,481,506
YDR232W,38,5,2,507,545
YDR232W,16,5,3,637,653
YDR232W,16,5,4,786,802
YDR232W,35,5,5,1508,1543
YGR276C,29,10,1,340,369
YGR276C,55,10,2,410,465
YGR276C,18,10,3,599,617
YGR276C,15,10,4,1244,1259
YGR276C,47,10,5,1296,1343
YGR276C,25,10,6,1454,1479
YGR276C,23,10,7,1483,1506
YGR276C,17,10,8,1510,1527
YGR276C,63,10,9,1577,1640
YGR276C,21,10,10,1641,1662
YOR052C,16,3,1,196,212
YOR052C,29,3,2,213,242
YOR052C,36,3,3,263,299
YBR017C,60,8,1,1050,1110
YBR017C,68,8,2,1114,1182
YBR017C,46,8,3,1185,1231
YBR017C,17,8,4,1239,1256
YBR017C,32,8,5,1773,1805
YBR017C,29,8,6,1806,1835
YBR017C,24,8,7,2187,2211
YBR017C,50,8,8,2222,2272
YKR014C,52,3,1,299,351
YKR014C,34,3,2,513,547
YKR014C,91,3,3,553,644
YPR162C,45,7,1,269,314
YPR162C,29,7,2,531,560
YPR162C,47,7,3,793,840
YPR162C,38,7,4,916,954
YPR162C,18,7,5,1207,1225
YPR162C,19,7,6,1396,1415
YPR162C,44,7,7,1475,1519
YHR175W,29,1,1,403,432
YNL044W,124,2,1,224,348
YNL044W,31,2,2,466,497
YNL161W,46,4,1,1008,1054
YNL161W,24,4,2,1315,1339
YNL161W,30,4,3,1411,1441
YNL161W,21,4,4,1883,1904
YHR065C,23,4,1,438,461
YHR065C,35,4,2,581,616
YHR065C,45,4,3,968,1013
YHR065C,21,4,4,1175,1196
YGL099W,115,10,1,320,435
YGL099W,86,10,2,540,626
YGL099W,33,10,3,743,776
YGL099W,40,10,4,850,890
YGL099W,55,10,5,1323,1378
YGL099W,19,10,6,1457,1476
YGL099W,22,10,7,1493,1515
YGL099W,25,10,8,1718,1743
YGL099W,40,10,9,1754,1794
YGL099W,21,10,10,1795,1816
YIL119C,50,3,1,291,341
YIL119C,17,3,2,495,512
YIL119C,27,3,3,664,691
YKL196C,83,1,1,350,433
YLR231C,68,6,1,483,551
YLR231C,57,6,2,561,618
YLR231C,21,6,3,644,665
YLR231C,30,6,4,725,755
YLR231C,36,6,5,997,1033
YLR231C,60,6,6,1299,1359
YNL129W,17,2,1,429,446
YNL129W,27,2,2,685,712
YJR139C,143,1,1,833,976
YKL016C,86,2,1,325,411
YKL016C,24,2,2,501,525
YBR133C,16,5,1,981,997
YBR133C,18,5,2,1635,1653
YBR133C,25,5,3,1927,1952
YBR133C,32,5,4,2096,2128
YBR133C,18,5,5,2197,2215
YGL017W,42,4,1,401,443
YGL017W,35,4,2,430,465
YGL017W,40,4,3,904,944
YGL017W,34,4,4,1125,1159
YBR162C,42,4,1,255,297
YBR162C,27,4,2,390,417
YBR162C,53,4,3,643,696
YBR162C,24,4,4,807,831
YDR279W,25,2,1,397,422
YDR279W,33,2,2,659,692
YDR143C,36,4,1,1250,1286
YDR143C,28,4,2,1296,1324
YDR143C,17,4,3,1331,1348
YDR143C,65,4,4,1336,1401
YBR111C,15,2,1,358,373
YBR111C,16,2,2,575,591
YMR108W,26,18,1,253,279
YMR108W,26,18,2,281,307
YMR108W,16,18,3,619,635
YMR108W,33,18,4,641,674
YMR108W,41,18,5,755,796
YMR108W,16,18,6,806,822
YMR108W,161,18,7,832,993
YMR108W,33,18,8,1034,1067
YMR108W,49,18,9,1097,1146
YMR108W,45,18,10,1253,1298
YMR108W,17,18,11,1306,1323
YMR108W,62,18,12,1324,1386
YMR108W,92,18,13,1431,1523
YMR108W,128,18,14,1531,1659
YMR108W,17,18,15,1725,1742
YMR108W,47,18,16,1839,1886
YMR108W,64,18,17,1891,1955
YMR108W,78,18,18,1972,2050
YFL047W,19,1,1,1596,1615
YLR380W,91,3,1,656,747
YLR380W,64,3,2,833,897
YLR380W,61,3,3,1019,1080
YJR042W,50,5,1,409,459
YJR042W,29,5,2,625,654
YJR042W,52,5,3,661,713
YJR042W,20,5,4,1817,1837
YJR042W,24,5,5,2114,2138
YMR012W,157,11,1,168,325
YMR012W,30,11,2,383,413
YMR012W,75,11,3,473,548
YMR012W,18,11,4,1106,1124
YMR012W,19,11,5,1974,1993
YMR012W,19,11,6,1999,2018
YMR012W,51,11,7,2183,2234
YMR012W,36,11,8,2866,2902
YMR012W,57,11,9,2892,2949
YMR012W,30,11,10,2960,2990
YMR012W,40,11,11,3255,3295
YPL160W,33,22,1,455,488
YPL160W,24,22,2,769,793
YPL160W,43,22,3,1181,1224
YPL160W,31,22,4,1358,1389
YPL160W,16,22,5,1411,1427
YPL160W,46,22,6,1428,1474
YPL160W,16,22,7,1507,1523
YPL160W,45,22,8,1524,1569
YPL160W,20,22,9,1610,1630
YPL160W,67,22,10,1622,1689
YPL160W,42,22,11,1718,1760
YPL160W,91,22,12,1868,1959
YPL160W,62,22,13,2448,2510
YPL160W,52,22,14,2523,2575
YPL160W,47,22,15,2604,2651
YPL160W,59,22,16,2720,2779
YPL160W,27,22,17,2969,2996
YPL160W,25,22,18,3015,3040
YPL160W,78,22,19,3057,3135
YPL160W,19,22,20,3143,3162
YPL160W,31,22,21,3166,3197
YPL160W,31,22,22,3207,3238
YGR100W,44,7,1,510,554
YGR100W,15,7,2,602,617
YGR100W,21,7,3,735,756
YGR100W,45,7,4,767,812
YGR100W,16,7,5,855,871
YGR100W,17,7,6,1188,1205
YGR100W,17,7,7,1281,1298
YPL026C,17,3,1,274,291
YPL026C,42,3,2,687,729
YPL026C,21,3,3,956,977
YDR214W,81,4,1,185,266
YDR214W,39,4,2,255,294
YDR214W,16,4,3,356,372
YDR214W,30,4,4,527,557
YIL126W,36,11,1,992,1028
YIL126W,26,11,2,1033,1059
YIL126W,26,11,3,1065,1091
YIL126W,16,11,4,1376,1392
YIL126W,31,11,5,1850,1881
YIL126W,20,11,6,1999,2019
YIL126W,17,11,7,2081,2098
YIL126W,20,11,8,2308,2328
YIL126W,17,11,9,2537,2554
YIL126W,46,11,10,2848,2894
YIL126W,19,11,11,4030,4049
YLR295C,93,1,1,279,372
YDL201W,25,6,1,370,395
YDL201W,64,6,2,404,468
YDL201W,18,6,3,518,536
YDL201W,40,6,4,526,566
YDL201W,15,6,5,574,589
YDL201W,32,6,6,789,821
YIL033C,16,3,1,745,761
YIL033C,21,3,2,942,963
YIL033C,34,3,3,1039,1073
YOL036W,48,8,1,173,221
YOL036W,20,8,2,250,270
YOL036W,31,8,3,268,299
YOL036W,15,8,4,311,326
YOL036W,15,8,5,368,383
YOL036W,22,8,6,640,662
YOL036W,17,8,7,954,971
YOL036W,46,8,8,1741,1787
YGR128C,40,13,1,165,205
YGR128C,19,13,2,249,268
YGR128C,15,13,3,560,575
YGR128C,33,13,4,576,609
YGR128C,40,13,5,636,676
YGR128C,40,13,6,777,817
YGR128C,56,13,7,824,880
YGR128C,18,13,8,993,1011
YGR128C,30,13,9,1194,1224
YGR128C,48,13,10,1394,1442
YGR128C,22,13,11,1566,1588
YGR128C,49,13,12,1724,1773
YGR128C,30,13,13,2109,2139
YDR189W,16,9,1,361,377
YDR189W,29,9,2,369,398
YDR189W,96,9,3,713,809
YDR189W,39,9,4,827,866
YDR189W,27,9,5,958,985
YDR189W,19,9,6,1509,1528
YDR189W,15,9,7,1529,1544
YDR189W,38,9,8,1553,1591
YDR189W,17,9,9,1791,1808
YOL056W,51,1,1,776,827
YOR075W,17,1,1,433,450
YFR052W,51,1,1,372,423
YBR282W,44,5,1,206,250
YBR282W,16,5,2,253,269
YBR282W,51,5,3,260,311
YBR282W,54,5,4,340,394
YBR282W,46,5,5,395,441
YDR404C,38,3,1,341,379
YDR404C,18,3,2,442,460
YDR404C,23,3,3,481,504
YOR026W,19,1,1,637,656
YMR083W,30,6,1,169,199
YMR083W,156,6,2,221,377
YMR083W,74,6,3,394,468
YMR083W,90,6,4,653,743
YMR083W,75,6,5,964,1039
YMR083W,67,6,6,1048,1115
YGL073W,26,6,1,609,635
YGL073W,22,6,2,664,686
YGL073W,18,6,3,698,716
YGL073W,37,6,4,1741,1778
YGL073W,23,6,5,1830,1853
YGL073W,30,6,6,1889,1919
YDR194C,20,6,1,297,317
YDR194C,35,6,2,331,366
YDR194C,18,6,3,582,600
YDR194C,36,6,4,648,684
YDR194C,28,6,5,685,713
YDR194C,16,6,6,1771,1787
YOL049W,44,5,1,324,368
YOL049W,37,5,2,650,687
YOL049W,37,5,3,874,911
YOL049W,77,5,4,939,1016
YOL049W,26,5,5,1419,1445
YMR244C-A,35,1,1,280,315
YMR189W,235,15,1,170,405
YMR189W,19,15,2,406,425
YMR189W,72,15,3,518,590
YMR189W,22,15,4,619,641
YMR189W,66,15,5,840,906
YMR189W,41,15,6,1066,1107
YMR189W,19,15,7,1612,1631
YMR189W,25,15,8,1953,1978
YMR189W,35,15,9,2074,2109
YMR189W,28,15,10,2562,2590
YMR189W,47,15,11,2701,2748
YMR189W,17,15,12,2759,2776
YMR189W,22,15,13,2777,2799
YMR189W,27,15,14,2801,2828
YMR189W,15,15,15,2842,2857
YIL093C,20,3,1,447,467
YIL093C,15,3,2,475,490
YIL093C,18,3,3,506,524
YLR397C,23,9,1,439,462
YLR397C,47,9,2,474,521
YLR397C,16,9,3,1115,1131
YLR397C,80,9,4,1587,1667
YLR397C,21,9,5,1798,1819
YLR397C,19,9,6,1831,1850
YLR397C,26,9,7,1936,1962
YLR397C,28,9,8,2107,2135
YLR397C,23,9,9,2157,2180
YJL210W,22,1,1,464,486
YFR045W,43,1,1,802,845
YIL104C,24,2,1,264,288
YIL104C,32,2,2,1021,1053
YGL086W,27,2,1,1858,1885
YGL086W,30,2,2,2183,2213
YGR159C,139,2,1,1004,1143
YGR159C,54,2,2,1155,1209
YAL044C,47,1,1,426,473
YBR213W,49,4,1,191,240
YBR213W,17,4,2,253,270
YBR213W,35,4,3,290,325
YBR213W,22,4,4,331,353
YKL081W,20,7,1,330,350
YKL081W,46,7,2,471,517
YKL081W,61,7,3,531,592
YKL081W,32,7,4,740,772
YKL081W,89,7,5,968,1057
YKL081W,26,7,6,1061,1087
YKL081W,50,7,7,1184,1234
YLR398C,33,20,1,575,608
YLR398C,45,20,2,774,819
YLR398C,42,20,3,841,883
YLR398C,21,20,4,1001,1022
YLR398C,39,20,5,1023,1062
YLR398C,59,20,6,1371,1430
YLR398C,24,20,7,1559,1583
YLR398C,111,20,8,1587,1698
YLR398C,25,20,9,1859,1884
YLR398C,21,20,10,1908,1929
YLR398C,25,20,11,2110,2135
YLR398C,22,20,12,2260,2282
YLR398C,36,20,13,2472,2508
YLR398C,28,20,14,2587,2615
YLR398C,24,20,15,2661,2685
YLR398C,23,20,16,2914,2937
YLR398C,24,20,17,2940,2964
YLR398C,20,20,18,3331,3351
YLR398C,27,20,19,3413,3440
YLR398C,45,20,20,3443,3488
YNL118C,24,3,1,355,379
YNL118C,21,3,2,1388,1409
YNL118C,24,3,3,1821,1845
YOL096C,65,6,1,214,279
YOL096C,89,6,2,372,461
YOL096C,30,6,3,594,624
YOL096C,28,6,4,665,693
YOL096C,26,6,5,733,759
YOL096C,22,6,6,876,898
YGR271W,48,6,1,396,444
YGR271W,17,6,2,1414,1431
YGR271W,18,6,3,3069,3087
YGR271W,17,6,4,4016,4033
YGR271W,31,6,5,5295,5326
YGR271W,15,6,6,5864,5879
YGR111W,24,2,1,1071,1095
YGR111W,23,2,2,1096,1119
YCL032W,18,2,1,392,410
YCL032W,29,2,2,397,426
YLR357W,119,13,1,848,967
YLR357W,22,13,2,976,998
YLR357W,17,13,3,1000,1017
YLR357W,51,13,4,1136,1187
YLR357W,129,13,5,1253,1382
YLR357W,71,13,6,1397,1468
YLR357W,37,13,7,1470,1507
YLR357W,20,13,8,1508,1528
YLR357W,16,13,9,1688,1704
YLR357W,48,13,10,1706,1754
YLR357W,25,13,11,1795,1820
YLR357W,25,13,12,1898,1923
YLR357W,29,13,13,2529,2558
YNL147W,23,1,1,259,282
YBR222C,25,7,1,237,262
YBR222C,21,7,2,477,498
YBR222C,20,7,3,620,640
YBR222C,58,7,4,641,699
YBR222C,17,7,5,879,896
YBR222C,20,7,6,970,990
YBR222C,18,7,7,1082,1100
YPR088C,33,2,1,219,252
YPR088C,74,2,2,609,683
YER127W,71,4,1,440,511
YER127W,27,4,2,512,539
YER127W,17,4,3,1027,1044
YER127W,21,4,4,1046,1067
YDL040C,31,10,1,868,899
YDL040C,28,10,2,1106,1134
YDL040C,22,10,3,1173,1195
YDL040C,33,10,4,1208,1241
YDL040C,26,10,5,1387,1413
YDL040C,43,10,6,1497,1540
YDL040C,33,10,7,1695,1728
YDL040C,50,10,8,1785,1835
YDL040C,78,10,9,1930,2008
YDL040C,27,10,10,2429,2456
YBR238C,32,8,1,284,316
YBR238C,36,8,2,318,354
YBR238C,25,8,3,399,424
YBR238C,18,8,4,431,449
YBR238C,15,8,5,648,663
YBR238C,28,8,6,871,899
YBR238C,53,8,7,958,1011
YBR238C,33,8,8,1207,1240
YDL015C,45,2,1,255,300
YDL015C,38,2,2,447,485
YOL086C,43,9,1,171,214
YOL086C,27,9,2,229,256
YOL086C,24,9,3,273,297
YOL086C,64,9,4,300,364
YOL086C,15,9,5,417,432
YOL086C,23,9,6,502,525
YOL086C,30,9,7,530,560
YOL086C,62,9,8,591,653
YOL086C,30,9,9,816,846
YLR017W,21,3,1,521,542
YLR017W,36,3,2,574,610
YLR017W,28,3,3,665,693
YDR430C,31,9,1,425,456
YDR430C,47,9,2,457,504
YDR430C,27,9,3,979,1006
YDR430C,35,9,4,1437,1472
YDR430C,18,9,5,1593,1611
YDR430C,18,9,6,1773,1791
YDR430C,68,9,7,1948,2016
YDR430C,17,9,8,2166,2183
YDR430C,24,9,9,2672,2696
YGR193C,76,8,1,177,253
YGR193C,30,8,2,240,270
YGR193C,29,8,3,292,321
YGR193C,16,8,4,640,656
YGR193C,24,8,5,770,794
YGR193C,73,8,6,795,868
YGR193C,15,8,7,1086,1101
YGR193C,31,8,8,1088,1119
YDR487C,23,2,1,309,332
YDR487C,28,2,2,598,626
YIL142W,15,7,1,420,435
YIL142W,34,7,2,437,471
YIL142W,60,7,3,860,920
YIL142W,33,7,4,1131,1164
YIL142W,18,7,5,1444,1462
YIL142W,41,7,6,1498,1539
YIL142W,36,7,7,1542,1578
YNR035C,17,2,1,491,508
YNR035C,52,2,2,662,714
YLR406C,104,1,1,238,342
YLR077W,20,6,1,209,229
YLR077W,35,6,2,662,697
YLR077W,21,6,3,1027,1048
YLR077W,27,6,4,1469,1496
YLR077W,17,6,5,1500,1517
YLR077W,22,6,6,1534,1556
YDR037W,53,8,1,536,589
YDR037W,49,8,2,682,731
YDR037W,25,8,3,811,836
YDR037W,28,8,4,902,930
YDR037W,19,8,5,1151,1170
YDR037W,23,8,6,1225,1248
YDR037W,15,8,7,1250,1265
YDR037W,80,8,8,1294,1374
YGR040W,28,8,1,263,291
YGR040W,36,8,2,293,329
YGR040W,27,8,3,377,404
YGR040W,18,8,4,603,621
YGR040W,16,8,5,684,700
YGR040W,47,8,6,887,934
YGR040W,17,8,7,947,964
YGR040W,25,8,8,1044,1069
YER178W,37,6,1,185,222
YER178W,41,6,2,236,277
YER178W,50,6,3,610,660
YER178W,76,6,4,806,882
YER178W,86,6,5,994,1080
YER178W,16,6,6,1186,1202
YFR014C,29,2,1,324,353
YFR014C,26,2,2,901,927
YHR121W,25,2,1,301,326
YHR121W,44,2,2,375,419
YHR034C,29,3,1,514,543
YHR034C,16,3,2,560,576
YHR034C,23,3,3,579,602
YOL070C,18,5,1,1073,1091
YOL070C,31,5,2,1179,1210
YOL070C,36,5,3,1217,1253
YOL070C,34,5,4,1249,1283
YOL070C,37,5,5,1350,1387
YOR188W,22,6,1,589,611
YOR188W,29,6,2,3101,3130
YOR188W,20,6,3,3144,3164
YOR188W,47,6,4,3192,3239
YOR188W,23,6,5,3263,3286
YOR188W,29,6,6,3285,3314
YLR452C,21,6,1,944,965
YLR452C,28,6,2,977,1005
YLR452C,27,6,3,1023,1050
YLR452C,30,6,4,1923,1953
YLR452C,35,6,5,2027,2062
YLR452C,21,6,6,2067,2088
YML103C,46,14,1,362,408
YML103C,17,14,2,858,875
YML103C,28,14,3,1314,1342
YML103C,26,14,4,1411,1437
YML103C,61,14,5,2690,2751
YML103C,32,14,6,2781,2813
YML103C,15,14,7,2981,2996
YML103C,17,14,8,3143,3160
YML103C,33,14,9,3176,3209
YML103C,18,14,10,3218,3236
YML103C,17,14,11,3534,3551
YML103C,22,14,12,3771,3793
YML103C,36,14,13,3830,3866
YML103C,35,14,14,4831,4866
YNR054C,49,1,1,425,474
YDR130C,18,4,1,345,363
YDR130C,33,4,2,399,432
YDR130C,16,4,3,721,737
YDR130C,36,4,4,840,876
YGL173C,42,9,1,336,378
YGL173C,37,9,2,1300,1337
YGL173C,27,9,3,1727,1754
YGL173C,39,9,4,1871,1910
YGL173C,26,9,5,2083,2109
YGL173C,29,9,6,2247,2276
YGL173C,24,9,7,2743,2767
YGL173C,49,9,8,2769,2818
YGL173C,32,9,9,3292,3324
YOL038W,66,5,1,272,338
YOL038W,49,5,2,340,389
YOL038W,84,5,3,502,586
YOL038W,82,5,4,594,676
YOL038W,55,5,5,693,748
YLR393W,48,4,1,271,319
YLR393W,17,4,2,431,448
YLR393W,19,4,3,462,481
YLR393W,18,4,4,736,754
YAR015W,28,4,1,193,221
YAR015W,25,4,2,364,389
YAR015W,34,4,3,394,428
YAR015W,90,4,4,694,784
YDR020C,19,2,1,313,332
YDR020C,24,2,2,363,387
YHR201C,48,2,1,333,381
YHR201C,22,2,2,540,562
YPL213W,25,5,1,227,252
YPL213W,18,5,2,259,277
YPL213W,18,5,3,316,334
YPL213W,15,5,4,470,485
YPL213W,44,5,5,478,522
YDR427W,28,3,1,170,198
YDR427W,24,3,2,298,322
YDR427W,20,3,3,323,343
YOR279C,62,1,1,230,292
YOR224C,52,1,1,240,292
YKL211C,52,11,1,254,306
YKL211C,27,11,2,373,400
YKL211C,43,11,3,578,621
YKL211C,17,11,4,780,797
YKL211C,123,11,5,930,1053
YKL211C,48,11,6,1127,1175
YKL211C,15,11,7,1180,1195
YKL211C,39,11,8,1201,1240
YKL211C,19,11,9,1307,1326
YKL211C,50,11,10,1342,1392
YKL211C,32,11,11,1407,1439
YLR079W,21,1,1,833,854
YJL030W,42,4,1,263,305
YJL030W,16,4,2,384,400
YJL030W,28,4,3,389,417
YJL030W,32,4,4,493,525
YMR093W,15,12,1,279,294
YMR093W,66,12,2,323,389
YMR093W,53,12,3,686,739
YMR093W,17,12,4,898,915
YMR093W,30,12,5,908,938
YMR093W,21,12,6,969,990
YMR093W,43,12,7,994,1037
YMR093W,15,12,8,1038,1053
YMR093W,25,12,9,1067,1092
YMR093W,40,12,10,1315,1355
YMR093W,50,12,11,1361,1411
YMR093W,30,12,12,1412,1442
YKR066C,162,7,1,162,324
YKR066C,109,7,2,337,446
YKR066C,77,7,3,478,555
YKR066C,32,7,4,682,714
YKR066C,32,7,5,856,888
YKR066C,28,7,6,952,980
YKR066C,36,7,7,1050,1086
YDR079W,45,1,1,210,255
YNL154C,15,1,1,718,733
YER043C,16,5,1,257,273
YER043C,63,5,2,647,710
YER043C,24,5,3,965,989
YER043C,75,5,4,1098,1173
YER043C,22,5,5,1250,1272
YGR191W,38,1,1,337,375
YOR150W,16,3,1,193,209
YOR150W,51,3,2,254,305
YOR150W,18,3,3,443,461
YDR055W,22,1,1,552,574
YBL061C,31,7,1,705,736
YBL061C,24,7,2,743,767
YBL061C,15,7,3,776,791
YBL061C,24,7,4,1268,1292
YBL061C,47,7,5,1293,1340
YBL061C,29,7,6,1402,1431
YBL061C,15,7,7,1437,1452
YMR140W,33,3,1,764,797
YMR140W,15,3,2,798,813
YMR140W,20,3,3,1041,1061
YBR034C,27,2,1,454,481
YBR034C,28,2,2,562,590
YLR401C,50,6,1,993,1043
YLR401C,53,6,2,1332,1385
YLR401C,15,6,3,1398,1413
YLR401C,29,6,4,1414,1443
YLR401C,38,6,5,1469,1507
YLR401C,15,6,6,1786,1801
YPL085W,56,13,1,1198,1254
YPL085W,51,13,2,1958,2009
YPL085W,22,13,3,2658,2680
YPL085W,17,13,4,2832,2849
YPL085W,16,13,5,3028,3044
YPL085W,76,13,6,3046,3122
YPL085W,53,13,7,3126,3179
YPL085W,45,13,8,3209,3254
YPL085W,30,13,9,3473,3503
YPL085W,18,13,10,3878,3896
YPL085W,48,13,11,4302,4350
YPL085W,15,13,12,4379,4394
YPL085W,70,13,13,4733,4803
YDL088C,53,2,1,1128,1181
YDL088C,24,2,2,1280,1304
YDL137W,30,1,1,369,399
YJR063W,46,1,1,226,272
YNL302C,33,1,1,402,435
YDR233C,20,2,1,773,793
YDR233C,19,2,2,801,820
YJL184W,25,1,1,343,368
YER025W,74,10,1,502,576
YER025W,73,10,2,590,663
YER025W,63,10,3,668,731
YER025W,20,10,4,749,769
YER025W,65,10,5,970,1035
YER025W,53,10,6,1036,1089
YER025W,63,10,7,1235,1298
YER025W,27,10,8,1358,1385
YER025W,22,10,9,1393,1415
YER025W,105,10,10,1457,1562
YDR527W,39,3,1,610,649
YDR527W,29,3,2,1153,1182
YDR527W,22,3,3,1288,1310
YKL139W,29,7,1,296,325
YKL139W,16,7,2,676,692
YKL139W,30,7,3,698,728
YKL139W,25,7,4,824,849
YKL139W,21,7,5,902,923
YKL139W,38,7,6,960,998
YKL139W,16,7,7,1335,1351
YCR059C,18,1,1,436,454
YML041C,22,1,1,604,626
YCR004C,15,1,1,533,548
YER078C,26,9,1,171,197
YER078C,44,9,2,222,266
YER078C,20,9,3,288,308
YER078C,28,9,4,351,379
YER078C,64,9,5,367,431
YER078C,31,9,6,479,510
YER078C,40,9,7,842,882
YER078C,16,9,8,1182,1198
YER078C,17,9,9,1287,1304
YER130C,33,2,1,836,869
YER130C,30,2,2,956,986
YDR115W,33,3,1,161,194
YDR115W,39,3,2,199,238
YDR115W,72,3,3,241,313
YGR132C,80,3,1,303,383
YGR132C,32,3,2,393,425
YGR132C,28,3,3,474,502
YER165W,22,9,1,364,386
YER165W,33,9,2,725,758
YER165W,54,9,3,778,832
YER165W,65,9,4,934,999
YER165W,76,9,5,1082,1158
YER165W,19,9,6,1196,1215
YER165W,57,9,7,1246,1303
YER165W,27,9,8,1304,1331
YER165W,79,9,9,1481,1560
YCL059C,20,2,1,467,487
YCL059C,29,2,2,549,578
YML014W,16,3,1,208,224
YML014W,36,3,2,636,672
YML014W,24,3,3,796,820
YKR071C,18,3,1,252,270
YKR071C,24,3,2,420,444
YKR071C,23,3,3,724,747
YGL112C,32,4,1,281,313
YGL112C,15,4,2,562,577
YGL112C,47,4,3,753,800
YGL112C,32,4,4,787,819
YOR233W,16,5,1,370,386
YOR233W,31,5,2,597,628
YOR233W,20,5,3,917,937
YOR233W,22,5,4,1532,1554
YOR233W,22,5,5,1622,1644
YBR127C,171,11,1,183,354
YBR127C,31,11,2,554,585
YBR127C,92,11,3,695,787
YBR127C,21,11,4,882,903
YBR127C,33,11,5,918,951
YBR127C,109,11,6,1062,1171
YBR127C,16,11,7,1172,1188
YBR127C,16,11,8,1235,1251
YBR127C,41,11,9,1271,1312
YBR127C,15,11,10,1339,1354
YBR127C,31,11,11,1358,1389
YPL235W,65,4,1,329,394
YPL235W,52,4,2,505,557
YPL235W,40,4,3,838,878
YPL235W,48,4,4,945,993
YBL050W,37,3,1,265,302
YBL050W,50,3,2,314,364
YBL050W,53,3,3,729,782
YOR047C,16,2,1,398,414
YOR047C,17,2,2,421,438
YGR280C,42,1,1,562,604
YGR237C,57,5,1,1132,1189
YGR237C,21,5,2,1592,1613
YGR237C,68,5,3,1698,1766
YGR237C,33,5,4,1875,1908
YGR237C,19,5,5,1911,1930
YBL087C,58,2,1,305,363
YBL087C,31,2,2,382,413
YJR014W,69,3,1,205,274
YJR014W,19,3,2,295,314
YJR014W,25,3,3,446,471
YGL190C,48,8,1,261,309
YGL190C,44,8,2,313,357
YGL190C,45,8,3,399,444
YGL190C,32,8,4,461,493
YGL190C,47,8,5,781,828
YGL190C,27,8,6,1061,1088
YGL190C,21,8,7,1120,1141
YGL190C,16,8,8,1158,1174
YPL018W,18,1,1,644,662
YMR075W,40,2,1,1033,1073
YMR075W,28,2,2,1561,1589
YGR202C,18,3,1,187,205
YGR202C,23,3,2,215,238
YGR202C,21,3,3,989,1010
YKL120W,71,8,1,265,336
YKL120W,59,8,2,362,421
YKL120W,51,8,3,572,623
YKL120W,29,8,4,669,698
YKL120W,35,8,5,720,755
YKL120W,60,8,6,742,802
YKL120W,37,8,7,893,930
YKL120W,18,8,8,939,957
YJR041C,21,10,1,494,515
YJR041C,38,10,2,972,1010
YJR041C,19,10,3,2476,2495
YJR041C,33,10,4,2489,2522
YJR041C,21,10,5,2637,2658
YJR041C,15,10,6,2873,2888
YJR041C,16,10,7,2915,2931
YJR041C,34,10,8,3012,3046
YJR041C,15,10,9,3126,3141
YJR041C,18,10,10,3371,3389
YKR028W,42,7,1,491,533
YKR028W,64,7,2,714,778
YKR028W,17,7,3,846,863
YKR028W,20,7,4,1456,1476
YKR028W,22,7,5,1481,1503
YKR028W,44,7,6,2156,2200
YKR028W,37,7,7,2211,2248
YHR169W,16,5,1,221,237
YHR169W,41,5,2,238,279
YHR169W,16,5,3,284,300
YHR169W,41,5,4,287,328
YHR169W,23,5,5,972,995
YMR286W,15,1,1,167,182
YDL175C,34,1,1,656,690
YHR104W,38,4,1,389,427
YHR104W,24,4,2,683,707
YHR104W,55,4,3,736,791
YHR104W,25,4,4,939,964
YDR447C,26,2,1,158,184
YDR447C,44,2,2,341,385
YDL004W,18,1,1,460,478
YDL102W,23,6,1,1549,1572
YDL102W,65,6,2,2075,2140
YDL102W,29,6,3,2299,2328
YDL102W,17,6,4,2337,2354
YDL102W,29,6,5,2420,2449
YDL102W,22,6,6,3125,3147
YJR009C,25,4,1,224,249
YJR009C,15,4,2,273,288
YJR009C,24,4,3,609,633
YJR009C,17,4,4,869,886
YPR145W,39,14,1,206,245
YPR145W,28,14,2,251,279
YPR145W,51,14,3,361,412
YPR145W,16,14,4,430,446
YPR145W,54,14,5,526,580
YPR145W,27,14,6,692,719
YPR145W,43,14,7,796,839
YPR145W,41,14,8,1138,1179
YPR145W,70,14,9,1167,1237
YPR145W,37,14,10,1318,1355
YPR145W,91,14,11,1420,1511
YPR145W,76,14,12,1515,1591
YPR145W,29,14,13,1601,1630
YPR145W,22,14,14,1635,1657
YJL063C,22,2,1,172,194
YJL063C,32,2,2,250,282
YOR293W,15,1,1,300,315
YML056C,35,9,1,332,367
YML056C,33,9,2,471,504
YML056C,23,9,3,632,655
YML056C,38,9,4,662,700
YML056C,34,9,5,709,743
YML056C,30,9,6,762,792
YML056C,16,9,7,932,948
YML056C,45,9,8,936,981
YML056C,70,9,9,1502,1572
YFL004W,70,6,1,169,239
YFL004W,40,6,2,240,280
YFL004W,24,6,3,781,805
YFL004W,31,6,4,1561,1592
YFL004W,69,6,5,1609,1678
YFL004W,31,6,6,2198,2229
YKL149C,25,5,1,652,677
YKL149C,18,5,2,735,753
YKL149C,20,5,3,793,813
YKL149C,16,5,4,814,830
YKL149C,40,5,5,818,858
YOR040W,37,2,1,527,564
YOR040W,32,2,2,749,781
YER139C,29,5,1,159,188
YER139C,22,5,2,189,211
YER139C,18,5,3,406,424
YER139C,31,5,4,425,456
YER139C,51,5,5,584,635
YLR433C,52,7,1,428,480
YLR433C,23,7,2,636,659
YLR433C,63,7,3,660,723
YLR433C,25,7,4,1187,1212
YLR433C,16,7,5,1214,1230
YLR433C,28,7,6,1232,1260
YLR433C,19,7,7,1299,1318
YMR153W,30,2,1,1321,1351
YMR153W,40,2,2,1374,1414
YMR124W,29,5,1,186,215
YMR124W,61,5,2,2455,2516
YMR124W,16,5,3,2536,2552
YMR124W,17,5,4,2574,2591
YMR124W,40,5,5,2697,2737
YER032W,31,6,1,355,386
YER032W,19,6,2,1181,1200
YER032W,17,6,3,1211,1228
YER032W,29,6,4,1276,1305
YER032W,16,6,5,1693,1709
YER032W,31,6,6,1721,1752
YJR070C,17,2,1,228,245
YJR070C,32,2,2,750,782
YDL097C,30,1,1,908,938
YGL005C,21,2,1,526,547
YGL005C,18,2,2,607,625
YGR262C,30,4,1,308,338
YGR262C,18,4,2,368,386
YGR262C,32,4,3,421,453
YGR262C,38,4,4,639,677
YDL111C,43,3,1,307,350
YDL111C,27,3,2,537,564
YDL111C,34,3,3,599,633
YPL245W,25,1,1,1170,1195
YLR104W,43,1,1,349,392
YOR132W,30,5,1,552,582
YOR132W,32,5,2,572,604
YOR132W,18,5,3,623,641
YOR132W,19,5,4,739,758
YOR132W,24,5,5,1556,1580
YJL158C,20,2,1,295,315
YJL158C,41,2,2,544,585
YIL003W,34,2,1,444,478
YIL003W,35,2,2,798,833
YPR080W,35,9,1,349,384
YPR080W,37,9,2,386,423
YPR080W,29,9,3,660,689
YPR080W,17,9,4,691,708
YPR080W,32,9,5,857,889
YPR080W,69,9,6,984,1053
YPR080W,80,9,7,1083,1163
YPR080W,21,9,8,1172,1193
YPR080W,21,9,9,1299,1320
YKL088W,24,5,1,937,961
YKL088W,26,5,2,966,992
YKL088W,61,5,3,1221,1282
YKL088W,18,5,4,1310,1328
YKL088W,25,5,5,1361,1386
YDR465C,47,1,1,1154,1201
YLR276C,27,4,1,1374,1401
YLR276C,39,4,2,1416,1455
YLR276C,36,4,3,1473,1509
YLR276C,19,4,4,1567,1586
YFR044C,66,5,1,230,296
YFR044C,15,5,2,443,458
YFR044C,16,5,3,462,478
YFR044C,48,5,4,1287,1335
YFR044C,39,5,5,1373,1412
YIL103W,64,2,1,556,620
YIL103W,35,2,2,759,794
YBR269C,21,1,1,210,231
YDR283C,36,13,1,263,299
YDR283C,24,13,2,321,345
YDR283C,31,13,3,791,822
YDR283C,154,13,4,866,1020
YDR283C,20,13,5,1131,1151
YDR283C,23,13,6,1152,1175
YDR283C,16,13,7,1182,1198
YDR283C,27,13,8,1434,1461
YDR283C,26,13,9,2107,2133
YDR283C,49,13,10,2431,2480
YDR283C,40,13,11,2467,2507
YDR283C,24,13,12,2690,2714
YDR283C,16,13,13,3752,3768
YBR192W,15,3,1,791,806
YBR192W,35,3,2,810,845
YBR192W,54,3,3,1070,1124
YER007C-A,59,1,1,300,359
YNR022C,45,3,1,213,258
YNR022C,16,3,2,273,289
YNR022C,35,3,3,293,328
YLR256W,27,4,1,1065,1092
YLR256W,38,4,2,2906,2944
YLR256W,20,4,3,3295,3315
YLR256W,16,4,4,3533,3549
YBR125C,28,5,1,309,337
YBR125C,17,5,2,338,355
YBR125C,37,5,3,667,704
YBR125C,23,5,4,711,734
YBR125C,15,5,5,864,879
YCL043C,88,1,1,315,403
YBR221C,68,6,1,195,263
YBR221C,39,6,2,444,483
YBR221C,30,6,3,711,741
YBR221C,21,6,4,745,766
YBR221C,47,6,5,772,819
YBR221C,106,6,6,917,1023
YAL005C,21,17,1,228,249
YAL005C,24,17,2,263,287
YAL005C,20,17,3,347,367
YAL005C,24,17,4,368,392
YAL005C,19,17,5,432,451
YAL005C,23,17,6,452,475
YAL005C,128,17,7,487,615
YAL005C,21,17,8,684,705
YAL005C,112,17,9,747,859
YAL005C,61,17,10,860,921
YAL005C,35,17,11,973,1008
YAL005C,48,17,12,1023,1071
YAL005C,30,17,13,1128,1158
YAL005C,81,17,14,1160,1241
YAL005C,22,17,15,1304,1326
YAL005C,53,17,16,1327,1380
YAL005C,32,17,17,1455,1487
YGR074W,32,2,1,271,303
YGR074W,15,2,2,304,319
YNL166C,16,2,1,1160,1176
YNL166C,42,2,2,1270,1312
YJR056C,35,2,1,456,491
YJR056C,24,2,2,687,711
YPL158C,15,5,1,822,837
YPL158C,18,5,2,1259,1277
YPL158C,68,5,3,1597,1665
YPL158C,17,5,4,1716,1733
YPL158C,16,5,5,2248,2264
YJL121C,23,5,1,305,328
YJL121C,35,5,2,460,495
YJL121C,17,5,3,503,520
YJL121C,44,5,4,524,568
YJL121C,19,5,5,657,676
YKL008C,31,2,1,194,225
YKL008C,29,2,2,215,244
YJL167W,41,3,1,246,287
YJL167W,60,3,2,449,509
YJL167W,36,3,3,728,764
YPL069C,25,1,1,945,970
YBR103W,56,3,1,794,850
YBR103W,17,3,2,852,869
YBR103W,34,3,3,1342,1376
YIL145C,19,1,1,516,535
YGL216W,67,5,1,166,233
YGL216W,28,5,2,235,263
YGL216W,20,5,3,299,319
YGL216W,17,5,4,386,403
YGL216W,32,5,5,531,563
YPL032C,23,19,1,488,511
YPL032C,19,19,2,762,781
YPL032C,28,19,3,885,913
YPL032C,25,19,4,1154,1179
YPL032C,16,19,5,1351,1367
YPL032C,16,19,6,1369,1385
YPL032C,15,19,7,1567,1582
YPL032C,27,19,8,1664,1691
YPL032C,32,19,9,1808,1840
YPL032C,17,19,10,1874,1891
YPL032C,22,19,11,1898,1920
YPL032C,126,19,12,1962,2088
YPL032C,15,19,13,2092,2107
YPL032C,54,19,14,2112,2166
YPL032C,52,19,15,2183,2235
YPL032C,22,19,16,2275,2297
YPL032C,61,19,17,2298,2359
YPL032C,17,19,18,2402,2419
YPL032C,40,19,19,2411,2451
YLR194C,24,4,1,357,381
YLR194C,45,4,2,393,438
YLR194C,18,4,3,499,517
YLR194C,27,4,4,555,582
YKL179C,36,3,1,863,899
YKL179C,15,3,2,1206,1221
YKL179C,15,3,3,2004,2019
YJL145W,50,3,1,315,365
YJL145W,19,3,2,409,428
YJL145W,22,3,3,560,582
YJL201W,25,8,1,451,476
YJL201W,44,8,2,464,508
YJL201W,25,8,3,672,697
YJL201W,50,8,4,894,944
YJL201W,32,8,5,1124,1156
YJL201W,18,8,6,1325,1343
YJL201W,34,8,7,1412,1446
YJL201W,32,8,8,1485,1517
YLR314C,189,7,1,462,651
YLR314C,17,7,2,659,676
YLR314C,31,7,3,680,711
YLR314C,43,7,4,720,763
YLR314C,29,7,5,752,781
YLR314C,61,7,6,887,948
YLR314C,37,7,7,1231,1268
YLR153C,100,12,1,213,313
YLR153C,20,12,2,318,338
YLR153C,45,12,3,410,455
YLR153C,17,12,4,610,627
YLR153C,22,12,5,713,735
YLR153C,36,12,6,888,924
YLR153C,19,12,7,1125,1144
YLR153C,33,12,8,1235,1268
YLR153C,44,12,9,1414,1458
YLR153C,29,12,10,1820,1849
YLR153C,15,12,11,1890,1905
YLR153C,25,12,12,1906,1931
YKL040C,68,2,1,613,681
YKL040C,28,2,2,740,768
YLR249W,46,14,1,485,531
YLR249W,31,14,2,677,708
YLR249W,29,14,3,772,801
YLR249W,220,14,4,904,1124
YLR249W,64,14,5,1273,1337
YLR249W,22,14,6,1493,1515
YLR249W,38,14,7,1532,1570
YLR249W,19,14,8,1891,1910
YLR249W,90,14,9,1914,2004
YLR249W,58,14,10,2107,2165
YLR249W,39,14,11,2798,2837
YLR249W,42,14,12,2843,2885
YLR249W,33,14,13,2935,2968
YLR249W,75,14,14,3016,3091
YNL004W,51,6,1,219,270
YNL004W,18,6,2,272,290
YNL004W,45,6,3,308,353
YNL004W,33,6,4,391,424
YNL004W,21,6,5,602,623
YNL004W,17,6,6,878,895
YOL139C,46,2,1,311,357
YOL139C,38,2,2,452,490
YBR207W,34,1,1,499,533
YDR184C,34,2,1,692,726
YDR184C,18,2,2,727,745
YCR043C,41,2,1,261,302
YCR043C,58,2,2,315,373
YKL210W,26,11,1,304,330
YKL210W,20,11,2,761,781
YKL210W,34,11,3,860,894
YKL210W,33,11,4,1001,1034
YKL210W,26,11,5,1050,1076
YKL210W,142,11,6,1774,1916
YKL210W,60,11,7,1923,1983
YKL210W,69,11,8,1993,2062
YKL210W,39,11,9,2184,2223
YKL210W,15,11,10,2344,2359
YKL210W,28,11,11,2948,2976
YOR278W,51,2,1,530,581
YOR278W,39,2,2,771,810
YNL085W,25,13,1,586,611
YNL085W,24,13,2,622,646
YNL085W,94,13,3,649,743
YNL085W,33,13,4,845,878
YNL085W,23,13,5,1121,1144
YNL085W,22,13,6,1150,1172
YNL085W,28,13,7,1342,1370
YNL085W,80,13,8,1549,1629
YNL085W,19,13,9,1747,1766
YNL085W,16,13,10,1771,1787
YNL085W,30,13,11,1961,1991
YNL085W,19,13,12,1992,2011
YNL085W,34,13,13,2172,2206
YDR394W,44,5,1,508,552
YDR394W,26,5,2,759,785
YDR394W,74,5,3,792,866
YDR394W,16,5,4,880,896
YDR394W,24,5,5,897,921
YPL210C,94,9,1,201,295
YPL210C,16,9,2,296,312
YPL210C,21,9,3,315,336
YPL210C,28,9,4,508,536
YPL210C,15,9,5,1100,1115
YPL210C,48,9,6,1125,1173
YPL210C,47,9,7,1454,1501
YPL210C,31,9,8,1515,1546
YPL210C,46,9,9,1730,1776
YOR087W,27,3,1,229,256
YOR087W,40,3,2,487,527
YOR087W,19,3,3,574,593
YKL057C,37,16,1,357,394
YKL057C,25,16,2,534,559
YKL057C,21,16,3,577,598
YKL057C,43,16,4,618,661
YKL057C,87,16,5,855,942
YKL057C,21,16,6,1005,1026
YKL057C,31,16,7,1145,1176
YKL057C,25,16,8,1177,1202
YKL057C,31,16,9,1463,1494
YKL057C,49,16,10,1521,1570
YKL057C,41,16,11,2185,2226
YKL057C,19,16,12,2360,2379
YKL057C,35,16,13,2644,2679
YKL057C,22,16,14,2841,2863
YKL057C,22,16,15,2882,2904
YKL057C,19,16,16,3035,3054
YIL114C,39,1,1,745,784
YGL234W,17,4,1,361,378
YGL234W,25,4,2,1022,1047
YGL234W,40,4,3,1560,1600
YGL234W,35,4,4,2186,2221
YOL082W,15,6,1,397,412
YOL082W,27,6,2,667,694
YOL082W,24,6,3,980,1004
YOL082W,35,6,4,996,1031
YOL082W,19,6,5,1071,1090
YOL082W,30,6,6,1084,1114
YOL155C,21,1,1,2760,2781
YNL108C,24,2,1,459,483
YNL108C,38,2,2,570,608
YFR053C,51,3,1,945,996
YFR053C,48,3,2,1126,1174
YFR053C,27,3,3,1311,1338
YMR301C,34,1,1,320,354
YGR186W,82,8,1,545,627
YGR186W,21,8,2,630,651
YGR186W,53,8,3,641,694
YGR186W,27,8,4,1173,1200
YGR186W,57,8,5,1363,1420
YGR186W,22,8,6,1443,1465
YGR186W,55,8,7,1787,1842
YGR186W,40,8,8,1979,2019
YDR294C,23,2,1,929,952
YDR294C,32,2,2,1578,1610
YFR002W,29,2,1,1320,1349
YFR002W,18,2,2,1774,1792
YJL217W,34,2,1,238,272
YJL217W,26,2,2,334,360
YOR027W,51,4,1,337,388
YOR027W,42,4,2,1121,1163
YOR027W,94,4,3,1364,1458
YOR027W,127,4,4,1489,1616
YDR325W,42,6,1,509,551
YDR325W,24,6,2,1004,1028
YDR325W,27,6,3,1114,1141
YDR325W,30,6,4,2272,2302
YDR325W,25,6,5,2458,2483
YDR325W,17,6,6,2489,2506
YBR181C,46,4,1,200,246
YBR181C,30,4,2,233,263
YBR181C,88,4,3,330,418
YBR181C,16,4,4,560,576
YMR188C,40,2,1,185,225
YMR188C,34,2,2,267,301
YNL131W,37,1,1,399,436
YLR226W,28,3,1,438,466
YLR226W,59,3,2,507,566
YLR226W,36,3,3,835,871
YOR243C,40,1,1,955,995
YER022W,23,4,1,1094,1117
YER022W,31,4,2,1305,1336
YER022W,24,4,3,1678,1702
YER022W,26,4,4,1766,1792
YDR041W,25,1,1,206,231
YGL047W,30,2,1,242,272
YGL047W,17,2,2,322,339
YKR070W,39,1,1,942,981
YMR205C,66,12,1,188,254
YMR205C,34,12,2,443,477
YMR205C,39,12,3,702,741
YMR205C,115,12,4,804,919
YMR205C,45,12,5,942,987
YMR205C,21,12,6,1641,1662
YMR205C,65,12,7,1739,1804
YMR205C,42,12,8,1872,1914
YMR205C,52,12,9,2035,2087
YMR205C,27,12,10,2099,2126
YMR205C,56,12,11,2412,2468
YMR205C,86,12,12,2667,2753
YCR005C,38,4,1,630,668
YCR005C,82,4,2,669,751
YCR005C,43,4,3,753,796
YCR005C,65,4,4,1127,1192
YER164W,34,11,1,839,873
YER164W,25,11,2,1060,1085
YER164W,33,11,3,1118,1151
YER164W,47,11,4,1239,1286
YER164W,23,11,5,1909,1932
YER164W,22,11,6,2568,2590
YER164W,23,11,7,2826,2849
YER164W,15,11,8,2893,2908
YER164W,45,11,9,2912,2957
YER164W,32,11,10,3385,3417
YER164W,38,11,11,3435,3473
YML017W,35,1,1,547,582
YHR037W,50,5,1,231,281
YHR037W,24,5,2,482,506
YHR037W,52,5,3,736,788
YHR037W,24,5,4,898,922
YHR037W,47,5,5,1151,1198
YOR274W,47,1,1,709,756
YBL051C,16,1,1,1742,1758
YLR089C,29,8,1,224,253
YLR089C,25,8,2,335,360
YLR089C,19,8,3,392,411
YLR089C,17,8,4,416,433
YLR089C,21,8,5,954,975
YLR089C,29,8,6,1101,1130
YLR089C,33,8,7,1427,1460
YLR089C,48,8,8,1508,1556
YNL080C,16,1,1,380,396
YGL028C,19,1,1,187,206
YPR048W,15,4,1,1096,1111
YPR048W,56,4,2,1286,1342
YPR048W,32,4,3,1635,1667
YPR048W,23,4,4,1794,1817
YBL027W,25,1,1,316,341
YHL013C,25,2,1,323,348
YHL013C,48,2,2,767,815
YOL060C,31,2,1,2042,2073
YOL060C,20,2,2,2081,2101
YGR009C,27,4,1,165,192
YGR009C,19,4,2,1001,1020
YGR009C,28,4,3,1023,1051
YGR009C,47,4,4,1662,1709
YGL105W,25,3,1,239,264
YGL105W,16,3,2,887,903
YGL105W,24,3,3,904,928
YDL076C,49,5,1,386,435
YDL076C,30,5,2,440,470
YDL076C,39,5,3,477,516
YDL076C,18,5,4,534,552
YDL076C,29,5,5,617,646
YDR120C,108,4,1,350,458
YDR120C,17,4,2,460,477
YDR120C,15,4,3,878,893
YDR120C,24,4,4,1462,1486
YER126C,20,3,1,202,222
YER126C,15,3,2,572,587
YER126C,30,3,3,728,758
YMR227C,33,1,1,702,735
YHR117W,21,5,1,528,549
YHR117W,17,5,2,570,587
YHR117W,52,5,3,1474,1526
YHR117W,28,5,4,1531,1559
YHR117W,42,5,5,1835,1877
YPL221W,18,1,1,152,170
YBL047C,15,3,1,561,576
YBL047C,27,3,2,623,650
YBL047C,21,3,3,664,685
YOR315W,21,12,1,245,266
YOR315W,18,12,2,290,308
YOR315W,17,12,3,310,327
YOR315W,47,12,4,366,413
YOR315W,19,12,5,418,437
YOR315W,78,12,6,554,632
YOR315W,35,12,7,661,696
YOR315W,45,12,8,701,746
YOR315W,42,12,9,752,794
YOR315W,26,12,10,835,861
YOR315W,39,12,11,937,976
YOR315W,43,12,12,983,1026
YEL051W,107,2,1,411,518
YEL051W,50,2,2,549,599
YOL004W,36,7,1,274,310
YOL004W,15,7,2,2126,2141
YOL004W,74,7,3,2808,2882
YOL004W,36,7,4,3662,3698
YOL004W,33,7,5,4084,4117
YOL004W,20,7,6,4132,4152
YOL004W,31,7,7,4158,4189
YGR014W,30,1,1,314,344
YGL050W,34,1,1,536,570
YDL036C,40,3,1,476,516
YDL036C,25,3,2,1136,1161
YDL036C,38,3,3,1326,1364
YMR032W,34,5,1,1157,1191
YMR032W,27,5,2,1199,1226
YMR032W,21,5,3,1738,1759
YMR032W,29,5,4,1824,1853
YMR032W,23,5,5,1925,1948
YMR150C,24,1,1,354,378
YFL007W,26,29,1,204,230
YFL007W,28,29,2,280,308
YFL007W,23,29,3,344,367
YFL007W,37,29,4,445,482
YFL007W,36,29,5,483,519
YFL007W,39,29,6,1178,1217
YFL007W,32,29,7,1204,1236
YFL007W,85,29,8,1274,1359
YFL007W,16,29,9,1367,1383
YFL007W,19,29,10,1497,1516
YFL007W,30,29,11,1621,1651
YFL007W,18,29,12,1652,1670
YFL007W,21,29,13,1940,1961
YFL007W,21,29,14,2928,2949
YFL007W,21,29,15,2954,2975
YFL007W,21,29,16,2976,2997
YFL007W,15,29,17,2999,3014
YFL007W,20,29,18,3233,3253
YFL007W,43,29,19,3612,3655
YFL007W,41,29,20,3660,3701
YFL007W,15,29,21,3911,3926
YFL007W,22,29,22,3927,3949
YFL007W,17,29,23,4100,4117
YFL007W,55,29,24,4114,4169
YFL007W,43,29,25,4555,4598
YFL007W,15,29,26,5196,5211
YFL007W,39,29,27,5882,5921
YFL007W,20,29,28,5997,6017
YFL007W,47,29,29,6141,6188
YKR045C,30,1,1,432,462
YPL099C,27,2,1,210,237
YPL099C,23,2,2,526,549
YCR012W,39,6,1,278,317
YCR012W,76,6,2,341,417
YCR012W,25,6,3,439,464
YCR012W,31,6,4,556,587
YCR012W,15,6,5,912,927
YCR012W,45,6,6,1025,1070
YGL026C,47,13,1,348,395
YGL026C,30,13,2,416,446
YGL026C,57,13,3,522,579
YGL026C,68,13,4,1244,1312
YGL026C,41,13,5,1527,1568
YGL026C,61,13,6,1616,1677
YGL026C,40,13,7,1757,1797
YGL026C,17,13,8,1821,1838
YGL026C,26,13,9,1841,1867
YGL026C,64,13,10,1875,1939
YGL026C,18,13,11,1948,1966
YGL026C,51,13,12,1953,2004
YGL026C,28,13,13,2096,2124
YMR072W,32,2,1,244,276
YMR072W,37,2,2,343,380
YNL045W,34,7,1,393,427
YNL045W,16,7,2,612,628
YNL045W,15,7,3,985,1000
YNL045W,37,7,4,998,1035
YNL045W,64,7,5,1383,1447
YNL045W,30,7,6,1630,1660
YNL045W,35,7,7,1842,1877
YMR310C,55,1,1,476,531
YHR191C,47,1,1,349,396
YDR354W,23,1,1,353,376
YDR301W,19,6,1,1380,1399
YDR301W,49,6,2,2124,2173
YDR301W,26,6,3,2174,2200
YDR301W,33,6,4,2801,2834
YDR301W,15,6,5,3479,3494
YDR301W,16,6,6,3523,3539
YJL053W,53,4,1,322,375
YJL053W,24,4,2,381,405
YJL053W,135,4,3,479,614
YJL053W,44,4,4,605,649
YGR214W,78,3,1,363,441
YGR214W,36,3,2,531,567
YGR214W,81,3,3,676,757
YCR083W,43,2,1,175,218
YCR083W,118,2,2,266,384
YMR143W,52,1,1,374,426
YOR151C,29,18,1,678,707
YOR151C,87,18,2,884,971
YOR151C,35,18,3,972,1007
YOR151C,26,18,4,1055,1081
YOR151C,33,18,5,1662,1695
YOR151C,56,18,6,1894,1950
YOR151C,26,18,7,1951,1977
YOR151C,25,18,8,1984,2009
YOR151C,46,18,9,2010,2056
YOR151C,17,18,10,2077,2094
YOR151C,15,18,11,2423,2438
YOR151C,35,18,12,2619,2654
YOR151C,35,18,13,3016,3051
YOR151C,82,18,14,3070,3152
YOR151C,30,18,15,3183,3213
YOR151C,26,18,16,3208,3234
YOR151C,71,18,17,3397,3468
YOR151C,25,18,18,3471,3496
YML028W,27,1,1,255,282
YLL001W,16,3,1,1405,1421
YLL001W,24,3,2,1502,1526
YLL001W,22,3,3,1599,1621
YOR168W,31,7,1,515,546
YOR168W,58,7,2,905,963
YOR168W,35,7,3,1249,1284
YOR168W,31,7,4,1498,1529
YOR168W,34,7,5,1793,1827
YOR168W,88,7,6,1902,1990
YOR168W,22,7,7,2247,2269
YNL189W,29,8,1,445,474
YNL189W,51,8,2,518,569
YNL189W,31,8,3,691,722
YNL189W,29,8,4,1000,1029
YNL189W,23,8,5,1037,1060
YNL189W,25,8,6,1072,1097
YNL189W,22,8,7,1322,1344
YNL189W,24,8,8,1421,1445
YMR027W,61,7,1,586,647
YMR027W,17,7,2,693,710
YMR027W,18,7,3,851,869
YMR027W,51,7,4,945,996
YMR027W,57,7,5,1000,1057
YMR027W,17,7,6,1285,1302
YMR027W,69,7,7,1342,1411
YPR173C,18,2,1,687,705
YPR173C,35,2,2,1003,1038
YJL031C,31,3,1,600,631
YJL031C,16,3,2,707,723
YJL031C,102,3,3,795,897
YER068W,28,6,1,458,486
YER068W,53,6,2,621,674
YER068W,15,6,3,1119,1134
YER068W,46,6,4,1588,1634
YER068W,41,6,5,1705,1746
YER068W,27,6,6,1735,1762
YMR269W,19,2,1,563,582
YMR269W,22,2,2,604,626
YKL053C-A,18,2,1,204,222
YKL053C-A,17,2,2,236,253
YLR043C,70,1,1,215,285
YJL008C,43,4,1,611,654
YJL008C,30,4,2,839,869
YJL008C,74,4,3,1465,1539
YJL008C,34,4,4,1541,1575
YDL018C,47,1,1,137,184
YML060W,36,1,1,672,708
YJR062C,19,4,1,355,374
YJR062C,43,4,2,500,543
YJR062C,36,4,3,649,685
YJR062C,19,4,4,1252,1271
YGL067W,27,11,1,155,182
YGL067W,20,11,2,201,221
YGL067W,30,11,3,209,239
YGL067W,83,11,4,263,346
YGL067W,18,11,5,353,371
YGL067W,33,11,6,508,541
YGL067W,55,11,7,816,871
YGL067W,30,11,8,864,894
YGL067W,40,11,9,900,940
YGL067W,30,11,10,932,962
YGL067W,15,11,11,980,995
YDL156W,43,6,1,835,878
YDL156W,24,6,2,1187,1211
YDL156W,33,6,3,1238,1271
YDL156W,16,6,4,1279,1295
YDL156W,22,6,5,1468,1490
YDL156W,17,6,6,1541,1558
YMR191W,15,4,1,280,295
YMR191W,45,4,2,593,638
YMR191W,17,4,3,919,936
YMR191W,32,4,4,978,1010
YPR073C,45,2,1,191,236
YPR073C,67,2,2,338,405
YML035C,72,11,1,722,794
YML035C,26,11,2,851,877
YML035C,25,11,3,1088,1113
YML035C,26,11,4,1138,1164
YML035C,15,11,5,1165,1180
YML035C,17,11,6,1182,1199
YML035C,28,11,7,1304,1332
YML035C,49,11,8,1484,1533
YML035C,36,11,9,1654,1690
YML035C,26,11,10,2313,2339
YML035C,48,11,11,2385,2433
YNL181W,142,9,1,214,356
YNL181W,30,9,2,410,440
YNL181W,22,9,3,469,491
YNL181W,23,9,4,492,515
YNL181W,24,9,5,704,728
YNL181W,22,9,6,962,984
YNL181W,23,9,7,992,1015
YNL181W,32,9,8,1016,1048
YNL181W,36,9,9,1054,1090
YHL039W,29,6,1,419,448
YHL039W,29,6,2,476,505
YHL039W,27,6,3,569,596
YHL039W,30,6,4,652,682
YHL039W,21,6,5,1202,1223
YHL039W,66,6,6,1350,1416
YDL136W,18,2,1,154,172
YDL136W,37,2,2,232,269
YCR090C,33,2,1,262,295
YCR090C,69,2,2,423,492
YKL056C,70,1,1,383,453
YAL060W,53,8,1,651,704
YAL060W,29,8,2,735,764
YAL060W,35,8,3,765,800
YAL060W,31,8,4,848,879
YAL060W,20,8,5,935,955
YAL060W,74,8,6,960,1034
YAL060W,23,8,7,1037,1060
YAL060W,16,8,8,1063,1079
YKL009W,42,3,1,175,217
YKL009W,30,3,2,461,491
YKL009W,22,3,3,503,525
YIL144W,15,1,1,887,902
YOR124C,42,15,1,706,748
YOR124C,22,15,2,770,792
YOR124C,25,15,3,1335,1360
YOR124C,62,15,4,1378,1440
YOR124C,39,15,5,1620,1659
YOR124C,18,15,6,1703,1721
YOR124C,30,15,7,1759,1789
YOR124C,26,15,8,1840,1866
YOR124C,30,15,9,1895,1925
YOR124C,24,15,10,2410,2434
YOR124C,26,15,11,2580,2606
YOR124C,43,15,12,3074,3117
YOR124C,20,15,13,3122,3142
YOR124C,16,15,14,3245,3261
YOR124C,18,15,15,3300,3318
YKR056W,93,7,1,1102,1195
YKR056W,18,7,2,1209,1227
YKR056W,20,7,3,1242,1262
YKR056W,45,7,4,1321,1366
YKR056W,158,7,5,1427,1585
YKR056W,32,7,6,1594,1626
YKR056W,25,7,7,1630,1655
YJR057W,17,1,1,314,331
YJL126W,21,1,1,659,680
YKL150W,78,3,1,414,492
YKL150W,21,3,2,614,635
YKL150W,39,3,3,781,820
YHR063C,49,4,1,435,484
YHR063C,29,4,2,477,506
YHR063C,51,4,3,696,747
YHR063C,21,4,4,829,850
YJL200C,54,12,1,359,413
YJL200C,58,12,2,893,951
YJL200C,17,12,3,1321,1338
YJL200C,21,12,4,1351,1372
YJL200C,32,12,5,1406,1438
YJL200C,23,12,6,1485,1508
YJL200C,20,12,7,1621,1641
YJL200C,34,12,8,1641,1675
YJL200C,24,12,9,1680,1704
YJL200C,16,12,10,1883,1899
YJL200C,46,12,11,1917,1963
YJL200C,75,12,12,2181,2256
YGL211W,32,3,1,487,519
YGL211W,36,3,2,804,840
YGL211W,15,3,3,973,988
YPL195W,20,11,1,353,373
YPL195W,28,11,2,586,614
YPL195W,25,11,3,623,648
YPL195W,25,11,4,926,951
YPL195W,24,11,5,1121,1145
YPL195W,15,11,6,1427,1442
YPL195W,19,11,7,1798,1817
YPL195W,18,11,8,1820,1838
YPL195W,19,11,9,1924,1943
YPL195W,31,11,10,1935,1966
YPL195W,18,11,11,2562,2580
YNL107W,30,3,1,231,261
YNL107W,18,3,2,311,329
YNL107W,20,3,3,339,359
YNL067W,86,1,1,190,276
YLR438W,18,2,1,236,254
YLR438W,24,2,2,608,632
YDR376W,18,4,1,271,289
YDR376W,15,4,2,304,319
YDR376W,29,4,3,800,829
YDR376W,38,4,4,1002,1040
YNL007C,34,2,1,140,174
YNL007C,26,2,2,1033,1059
YKL096W,19,2,1,325,344
YKL096W,35,2,2,522,557
YDR089W,31,4,1,236,267
YDR089W,24,4,2,532,556
YDR089W,16,4,3,599,615
YDR089W,29,4,4,1976,2005
YKL014C,24,9,1,282,306
YKL014C,31,9,2,524,555
YKL014C,34,9,3,2174,2208
YKL014C,24,9,4,2540,2564
YKL014C,32,9,5,2616,2648
YKL014C,16,9,6,3526,3542
YKL014C,32,9,7,4329,4361
YKL014C,15,9,8,4478,4493
YKL014C,18,9,9,4644,4662
YDR129C,47,5,1,934,981
YDR129C,33,5,2,1017,1050
YDR129C,29,5,3,1051,1080
YDR129C,39,5,4,1158,1197
YDR129C,31,5,5,1205,1236
YPR119W,33,1,1,866,899
YDR378C,47,1,1,208,255
YBL086C,16,3,1,362,378
YBL086C,21,3,2,1089,1110
YBL086C,15,3,3,1112,1127
YKR029C,48,4,1,1092,1140
YKR029C,60,4,2,1142,1202
YKR029C,17,4,3,1219,1236
YKR029C,30,4,4,1777,1807
YGL191W,20,2,1,281,301
YGL191W,44,2,2,308,352
YJL104W,23,1,1,322,345
YPL019C,46,5,1,335,381
YPL019C,51,5,2,779,830
YPL019C,22,5,3,1325,1347
YPL019C,27,5,4,1382,1409
YPL019C,15,5,5,1506,1521
YGR233C,32,11,1,643,675
YGR233C,28,11,2,1761,1789
YGR233C,40,11,3,1778,1818
YGR233C,52,11,4,1841,1893
YGR233C,28,11,5,2064,2092
YGR233C,21,11,6,2306,2327
YGR233C,48,11,7,2333,2381
YGR233C,18,11,8,2711,2729
YGR233C,19,11,9,3002,3021
YGR233C,21,11,10,3044,3065
YGR233C,75,11,11,3462,3537
YJL168C,55,2,1,1251,1306
YJL168C,25,2,2,1561,1586
YDR145W,20,3,1,249,269
YDR145W,18,3,2,929,947
YDR145W,33,3,3,1573,1606
YFL009W,29,10,1,236,265
YFL009W,30,10,2,1253,1283
YFL009W,21,10,3,1361,1382
YFL009W,17,10,4,1898,1915
YFL009W,33,10,5,1919,1952
YFL009W,49,10,6,2019,2068
YFL009W,23,10,7,2081,2104
YFL009W,40,10,8,2126,2166
YFL009W,20,10,9,2167,2187
YFL009W,33,10,10,2264,2297
YDL174C,20,4,1,208,228
YDL174C,28,4,2,305,333
YDL174C,19,4,3,1123,1142
YDL174C,15,4,4,1143,1158
YER091C,28,6,1,261,289
YER091C,102,6,2,1336,1438
YER091C,28,6,3,1439,1467
YER091C,18,6,4,1486,1504
YER091C,18,6,5,1506,1524
YER091C,210,6,6,1695,1905
YIR024C,22,1,1,266,288
YDL103C,27,7,1,295,322
YDL103C,51,7,2,432,483
YDL103C,31,7,3,647,678
YDL103C,27,7,4,950,977
YDL103C,25,7,5,1263,1288
YDL103C,83,7,6,1299,1382
YDL103C,26,7,7,1404,1430
YDL203C,18,5,1,728,746
YDL203C,32,5,2,734,766
YDL203C,19,5,3,1066,1085
YDL203C,29,5,4,1189,1218
YDL203C,23,5,5,1711,1734
YFR024C-A,18,3,1,347,365
YFR024C-A,43,3,2,725,768
YFR024C-A,32,3,3,1345,1377
YLR215C,29,2,1,246,275
YLR215C,15,2,2,843,858
YML082W,22,7,1,247,269
YML082W,75,7,2,381,456
YML082W,49,7,3,470,519
YML082W,22,7,4,808,830
YML082W,15,7,5,1022,1037
YML082W,23,7,6,1103,1126
YML082W,19,7,7,1150,1169
YKL130C,22,2,1,301,323
YKL130C,23,2,2,333,356
YOR106W,26,2,1,363,389
YOR106W,15,2,2,416,431
YNL236W,33,6,1,542,575
YNL236W,43,6,2,1011,1054
YNL236W,25,6,3,1071,1096
YNL236W,17,6,4,1217,1234
YNL236W,23,6,5,1315,1338
YNL236W,23,6,6,1575,1598
YOR346W,21,16,1,662,683
YOR346W,16,16,2,684,700
YOR346W,29,16,3,1133,1162
YOR346W,18,16,4,1187,1205
YOR346W,20,16,5,1521,1541
YOR346W,34,16,6,1599,1633
YOR346W,21,16,7,1730,1751
YOR346W,33,16,8,2031,2064
YOR346W,48,16,9,2122,2170
YOR346W,33,16,10,2171,2204
YOR346W,17,16,11,2259,2276
YOR346W,64,16,12,2343,2407
YOR346W,60,16,13,2663,2723
YOR346W,32,16,14,2768,2800
YOR346W,75,16,15,2804,2879
YOR346W,35,16,16,2904,2939
YFR001W,60,2,1,329,389
YFR001W,55,2,2,388,443
YIL115C,15,13,1,918,933
YIL115C,21,13,2,967,988
YIL115C,24,13,3,1092,1116
YIL115C,44,13,4,2675,2719
YIL115C,51,13,5,2829,2880
YIL115C,29,13,6,2982,3011
YIL115C,20,13,7,3109,3129
YIL115C,30,13,8,3232,3262
YIL115C,37,13,9,3887,3924
YIL115C,17,13,10,4008,4025
YIL115C,31,13,11,4030,4061
YIL115C,33,13,12,4182,4215
YIL115C,45,13,13,4294,4339
YGL233W,25,6,1,672,697
YGL233W,33,6,2,685,718
YGL233W,24,6,3,1494,1518
YGL233W,31,6,4,1765,1796
YGL233W,42,6,5,1808,1850
YGL233W,31,6,6,2672,2703
YJL088W,23,2,1,899,922
YJL088W,44,2,2,916,960
YLR319C,23,8,1,337,360
YLR319C,15,8,2,414,429
YLR319C,17,8,3,1043,1060
YLR319C,17,8,4,1908,1925
YLR319C,30,8,5,1914,1944
YLR319C,16,8,6,2108,2124
YLR319C,16,8,7,2291,2307
YLR319C,15,8,8,2315,2330
YKL033W-A,58,7,1,257,315
YKL033W-A,26,7,2,309,335
YKL033W-A,25,7,3,337,362
YKL033W-A,23,7,4,372,395
YKL033W-A,70,7,5,472,542
YKL033W-A,19,7,6,623,642
YKL033W-A,39,7,7,644,683
YNL190W,38,2,1,168,206
YNL190W,37,2,2,514,551
YMR235C,85,5,1,213,298
YMR235C,58,5,2,342,400
YMR235C,42,5,3,429,471
YMR235C,87,5,4,738,825
YMR235C,48,5,5,987,1035
YOR341W,119,36,1,447,566
YOR341W,48,36,2,929,977
YOR341W,20,36,3,1122,1142
YOR341W,82,36,4,1160,1242
YOR341W,32,36,5,1388,1420
YOR341W,33,36,6,1643,1676
YOR341W,18,36,7,1682,1700
YOR341W,17,36,8,1705,1722
YOR341W,19,36,9,1933,1952
YOR341W,22,36,10,1959,1981
YOR341W,54,36,11,1989,2043
YOR341W,19,36,12,2135,2154
YOR341W,19,36,13,2215,2234
YOR341W,35,36,14,2260,2295
YOR341W,20,36,15,2566,2586
YOR341W,22,36,16,2606,2628
YOR341W,49,36,17,2842,2891
YOR341W,34,36,18,2912,2946
YOR341W,22,36,19,3085,3107
YOR341W,70,36,20,3108,3178
YOR341W,25,36,21,3253,3278
YOR341W,27,36,22,3297,3324
YOR341W,29,36,23,3357,3386
YOR341W,50,36,24,3452,3502
YOR341W,34,36,25,3496,3530
YOR341W,33,36,26,3590,3623
YOR341W,30,36,27,4000,4030
YOR341W,54,36,28,4032,4086
YOR341W,18,36,29,4143,4161
YOR341W,36,36,30,4434,4470
YOR341W,27,36,31,4605,4632
YOR341W,41,36,32,4638,4679
YOR341W,18,36,33,4765,4783
YOR341W,31,36,34,4787,4818
YOR341W,19,36,35,4927,4946
YOR341W,33,36,36,4948,4981
YHR029C,35,2,1,337,372
YHR029C,43,2,2,384,427
YPL091W,60,6,1,375,435
YPL091W,32,6,2,546,578
YPL091W,20,6,3,585,605
YPL091W,29,6,4,795,824
YPL091W,17,6,5,825,842
YPL091W,30,6,6,1343,1373
YLR203C,48,7,1,395,443
YLR203C,34,7,2,512,546
YLR203C,16,7,3,554,570
YLR203C,19,7,4,855,874
YLR203C,21,7,5,1172,1193
YLR203C,15,7,6,1271,1286
YLR203C,24,7,7,1287,1311
YGR155W,38,5,1,419,457
YGR155W,50,5,2,831,881
YGR155W,21,5,3,1108,1129
YGR155W,84,5,4,1262,1346
YGR155W,48,5,5,1378,1426
YMR300C,16,9,1,468,484
YMR300C,44,9,2,705,749
YMR300C,21,9,3,789,810
YMR300C,24,9,4,824,848
YMR300C,70,9,5,876,946
YMR300C,58,9,6,1101,1159
YMR300C,70,9,7,1160,1230
YMR300C,42,9,8,1264,1306
YMR300C,18,9,9,1421,1439
YFR049W,52,1,1,320,372
YNL130C,19,2,1,237,256
YNL130C,65,2,2,265,330
YNR036C,32,3,1,182,214
YNR036C,16,3,2,219,235
YNR036C,143,3,3,317,460
YNR049C,64,6,1,295,359
YNR049C,48,6,2,346,394
YNR049C,37,6,3,409,446
YNR049C,34,6,4,433,467
YNR049C,15,6,5,501,516
YNR049C,28,6,6,544,572
YLR342W,29,8,1,1070,1099
YLR342W,36,8,2,1202,1238
YLR342W,36,8,3,1475,1511
YLR342W,25,8,4,3319,3344
YLR342W,54,8,5,3453,3507
YLR342W,33,8,6,3526,3559
YLR342W,15,8,7,3940,3955
YLR342W,40,8,8,3942,3982
YLR335W,43,7,1,478,521
YLR335W,24,7,2,532,556
YLR335W,18,7,3,635,653
YLR335W,38,7,4,854,892
YLR335W,67,7,5,879,946
YLR335W,26,7,6,2061,2087
YLR335W,37,7,7,2088,2125
YNL251C,17,4,1,1147,1164
YNL251C,51,4,2,1274,1325
YNL251C,21,4,3,1338,1359
YNL251C,23,4,4,1703,1726
YJR102C,28,1,1,453,481
YOR020C,32,1,1,173,205
YBL004W,44,8,1,1244,1288
YBL004W,73,8,2,2506,2579
YBL004W,25,8,3,2883,2908
YBL004W,15,8,4,3112,3127
YBL004W,21,8,5,3146,3167
YBL004W,51,8,6,3370,3421
YBL004W,20,8,7,3665,3685
YBL004W,25,8,8,5361,5386
YBR164C,105,1,1,324,429
YIL153W,33,3,1,425,458
YIL153W,15,3,2,845,860
YIL153W,18,3,3,1031,1049
YJR088C,37,2,1,586,623
YJR088C,43,2,2,689,732
YHR074W,17,18,1,238,255
YHR074W,17,18,2,286,303
YHR074W,90,18,3,437,527
YHR074W,21,18,4,688,709
YHR074W,32,18,5,811,843
YHR074W,28,18,6,966,994
YHR074W,18,18,7,1031,1049
YHR074W,60,18,8,1091,1151
YHR074W,41,18,9,1262,1303
YHR074W,34,18,10,1336,1370
YHR074W,16,18,11,1430,1446
YHR074W,43,18,12,1439,1482
YHR074W,34,18,13,1585,1619
YHR074W,27,18,14,1651,1678
YHR074W,33,18,15,1694,1727
YHR074W,54,18,16,1745,1799
YHR074W,21,18,17,1844,1865
YHR074W,40,18,18,2062,2102
YGR104C,48,7,1,219,267
YGR104C,31,7,2,263,294
YGR104C,19,7,3,335,354
YGR104C,15,7,4,485,500
YGR104C,16,7,5,786,802
YGR104C,24,7,6,804,828
YGR104C,18,7,7,884,902
YLR399C,21,2,1,670,691
YLR399C,37,2,2,1293,1330
YGR277C,40,1,1,710,750
YFR030W,22,15,1,334,356
YFR030W,45,15,2,357,402
YFR030W,27,15,3,595,622
YFR030W,49,15,4,1174,1223
YFR030W,36,15,5,1311,1347
YFR030W,31,15,6,1575,1606
YFR030W,19,15,7,1629,1648
YFR030W,17,15,8,1730,1747
YFR030W,39,15,9,1748,1787
YFR030W,59,15,10,2101,2160
YFR030W,23,15,11,2233,2256
YFR030W,16,15,12,2540,2556
YFR030W,17,15,13,2561,2578
YFR030W,43,15,14,2719,2762
YFR030W,29,15,15,2905,2934
YOR006C,33,7,1,353,386
YOR006C,42,7,2,413,455
YOR006C,35,7,3,444,479
YOR006C,39,7,4,485,524
YOR006C,15,7,5,543,558
YOR006C,16,7,6,572,588
YOR006C,35,7,7,692,727
YJL146W,15,2,1,1243,1258
YJL146W,15,2,2,1259,1274
YBR244W,40,1,1,411,451
YPL053C,52,1,1,242,294
YBR179C,24,13,1,417,441
YBR179C,51,13,2,489,540
YBR179C,53,13,3,622,675
YBR179C,32,13,4,677,709
YBR179C,20,13,5,739,759
YBR179C,17,13,6,829,846
YBR179C,15,13,7,855,870
YBR179C,20,13,8,874,894
YBR179C,53,13,9,1008,1061
YBR179C,25,13,10,1271,1296
YBR179C,20,13,11,1655,1675
YBR179C,32,13,12,1710,1742
YBR179C,38,13,13,2190,2228
YPL155C,65,5,1,439,504
YPL155C,49,5,2,503,552
YPL155C,47,5,3,553,600
YPL155C,30,5,4,711,741
YPL155C,15,5,5,1685,1700
YOL094C,16,3,1,610,626
YOL094C,23,3,2,629,652
YOL094C,31,3,3,882,913
YHR018C,28,2,1,315,343
YHR018C,51,2,2,490,541
YDR408C,29,2,1,356,385
YDR408C,15,2,2,471,486
YBR126C,64,4,1,605,669
YBR126C,115,4,2,929,1044
YBR126C,15,4,3,1101,1116
YBR126C,32,4,4,1108,1140
YOL149W,38,2,1,390,428
YOL149W,20,2,2,609,629
YLR257W,39,2,1,848,887
YLR257W,29,2,2,891,920
YGL202W,23,6,1,526,549
YGL202W,53,6,2,901,954
YGL202W,60,6,3,1078,1138
YGL202W,22,6,4,1299,1321
YGL202W,17,6,5,1420,1437
YGL202W,34,6,6,1445,1479
YPL106C,62,12,1,258,320
YPL106C,29,12,2,455,484
YPL106C,49,12,3,558,607
YPL106C,44,12,4,1042,1086
YPL106C,43,12,5,1089,1132
YPL106C,65,12,6,1275,1340
YPL106C,17,12,7,1361,1378
YPL106C,50,12,8,1421,1471
YPL106C,33,12,9,1515,1548
YPL106C,57,12,10,1551,1608
YPL106C,28,12,11,1697,1725
YPL106C,25,12,12,1978,2003
YOR046C,44,6,1,246,290
YOR046C,15,6,2,297,312
YOR046C,63,6,3,351,414
YOR046C,122,6,4,623,745
YOR046C,31,6,5,839,870
YOR046C,108,6,6,883,991
YKR035W-A,70,1,1,391,461
YNL141W,38,1,1,874,912
YMR220W,74,7,1,299,373
YMR220W,45,7,2,502,547
YMR220W,25,7,3,604,629
YMR220W,34,7,4,616,650
YMR220W,66,7,5,776,842
YMR220W,45,7,6,968,1013
YMR220W,38,7,7,1170,1208
YPR187W,100,1,1,367,467
YDR121W,36,2,1,450,486
YDR121W,36,2,2,476,512
YER125W,24,10,1,172,196
YER125W,31,10,2,353,384
YER125W,46,10,3,1464,1510
YER125W,23,10,4,1523,1546
YER125W,30,10,5,1533,1563
YER125W,75,10,6,1849,1924
YER125W,57,10,7,2023,2080
YER125W,28,10,8,2082,2110
YER125W,23,10,9,2309,2332
YER125W,46,10,10,2319,2365
YDR432W,71,4,1,352,423
YDR432W,185,4,2,492,677
YDR432W,76,4,3,685,761
YDR432W,17,4,4,1182,1199
YGR195W,20,1,1,448,468
YOR222W,51,2,1,343,394
YOR222W,29,2,2,878,907
YOL061W,98,9,1,369,467
YOL061W,24,9,2,556,580
YOL061W,52,9,3,581,633
YOL061W,28,9,4,641,669
YOL061W,39,9,5,670,709
YOL061W,74,9,6,893,967
YOL061W,68,9,7,1028,1096
YOL061W,39,9,8,1151,1190
YOL061W,58,9,9,1364,1422
YHR174W,28,2,1,588,616
YHR174W,30,2,2,1016,1046
YPL259C,25,11,1,185,210
YPL259C,24,11,2,335,359
YPL259C,20,11,3,454,474
YPL259C,18,11,4,532,550
YPL259C,22,11,5,956,978
YPL259C,33,11,6,1057,1090
YPL259C,21,11,7,1096,1117
YPL259C,53,11,8,1119,1172
YPL259C,22,11,9,1310,1332
YPL259C,20,11,10,1353,1373
YPL259C,23,11,11,1404,1427
YPL220W,20,5,1,275,295
YPL220W,49,5,2,296,345
YPL220W,17,5,3,347,364
YPL220W,17,5,4,457,474
YPL220W,44,5,5,576,620
YJL191W,41,5,1,154,195
YJL191W,37,5,2,196,233
YJL191W,28,5,3,238,266
YJL191W,19,5,4,339,358
YJL191W,57,5,5,359,416
YLR055C,85,2,1,1624,1709
YLR055C,31,2,2,1725,1756
YGR017W,37,1,1,255,292
YDR031W,15,1,1,272,287
YOR198C,57,6,1,208,265
YOR198C,22,6,2,272,294
YOR198C,25,6,3,900,925
YOR198C,20,6,4,965,985
YOR198C,26,6,5,1031,1057
YOR198C,39,6,6,1185,1224
YOR213C,15,1,1,197,212
YEL050C,85,10,1,236,321
YEL050C,50,10,2,313,363
YEL050C,18,10,3,373,391
YEL050C,17,10,4,397,414
YEL050C,74,10,5,442,516
YEL050C,24,10,6,518,542
YEL050C,35,10,7,594,629
YEL050C,24,10,8,645,669
YEL050C,20,10,9,780,800
YEL050C,43,10,10,1136,1179
YNL081C,25,1,1,239,264
YHR016C,51,1,1,715,766
YLR450W,38,4,1,189,227
YLR450W,23,4,2,245,268
YLR450W,15,4,3,2558,2573
YLR450W,22,4,4,2729,2751
YGL224C,26,2,1,724,750
YGL224C,38,2,2,751,789
YOL123W,49,2,1,605,654
YOL123W,36,2,2,721,757
YNL084C,64,2,1,197,261
YNL084C,29,2,2,826,855
YGL066W,36,17,1,165,201
YGL066W,34,17,2,203,237
YGL066W,17,17,3,246,263
YGL066W,83,17,4,301,384
YGL066W,35,17,5,387,422
YGL066W,29,17,6,424,453
YGL066W,22,17,7,493,515
YGL066W,25,17,8,693,718
YGL066W,25,17,9,931,956
YGL066W,15,17,10,959,974
YGL066W,24,17,11,1019,1043
YGL066W,18,17,12,1151,1169
YGL066W,24,17,13,1232,1256
YGL066W,17,17,14,1346,1363
YGL066W,36,17,15,1364,1400
YGL066W,77,17,16,1428,1505
YGL066W,23,17,17,1564,1587
YBR265W,20,2,1,689,709
YBR265W,51,2,2,752,803
YBR084C-A,28,1,1,318,346
YHR207C,28,2,1,559,587
YHR207C,30,2,2,1363,1393
YER141W,138,7,1,257,395
YER141W,20,7,2,401,421
YER141W,99,7,3,431,530
YER141W,27,7,4,924,951
YER141W,20,7,5,1166,1186
YER141W,19,7,6,1187,1206
YER141W,29,7,7,1300,1329
YNL220W,17,7,1,271,288
YNL220W,21,7,2,338,359
YNL220W,36,7,3,350,386
YNL220W,51,7,4,417,468
YNL220W,75,7,5,480,555
YNL220W,27,7,6,785,812
YNL220W,20,7,7,1084,1104
YGL169W,39,5,1,638,677
YGL169W,54,5,2,678,732
YGL169W,31,5,3,972,1003
YGL169W,40,5,4,994,1034
YGL169W,36,5,5,1159,1195
YCL064C,59,5,1,273,332
YCL064C,100,5,2,370,470
YCL064C,21,5,3,490,511
YCL064C,39,5,4,800,839
YCL064C,74,5,5,887,961
YER174C,21,3,1,311,332
YER174C,28,3,2,354,382
YER174C,27,3,3,618,645
YML029W,45,6,1,479,524
YML029W,25,6,2,1041,1066
YML029W,16,6,3,1134,1150
YML029W,21,6,4,1494,1515
YML029W,21,6,5,1646,1667
YML029W,24,6,6,1707,1731
YNL313C,18,10,1,1354,1372
YNL313C,22,10,2,1565,1587
YNL313C,23,10,3,1944,1967
YNL313C,26,10,4,2017,2043
YNL313C,36,10,5,2031,2067
YNL313C,26,10,6,2104,2130
YNL313C,26,10,7,2133,2159
YNL313C,31,10,8,2161,2192
YNL313C,30,10,9,2183,2213
YNL313C,63,10,10,2498,2561
YHR094C,40,2,1,211,251
YHR094C,26,2,2,272,298
YGL031C,39,1,1,258,297
YCR048W,77,6,1,489,566
YCR048W,50,6,2,587,637
YCR048W,31,6,3,673,704
YCR048W,21,6,4,717,738
YCR048W,32,6,5,739,771
YCR048W,27,6,6,773,800
YDL182W,41,7,1,184,225
YDL182W,49,7,2,494,543
YDL182W,55,7,3,559,614
YDL182W,20,7,4,1046,1066
YDL182W,24,7,5,1102,1126
YDL182W,39,7,6,1168,1207
YDL182W,64,7,7,1208,1272
YMR091C,40,5,1,410,450
YMR091C,23,5,2,588,611
YMR091C,22,5,3,673,695
YMR091C,24,5,4,728,752
YMR091C,22,5,5,754,776
YER012W,22,1,1,340,362
YDR222W,32,6,1,294,326
YDR222W,45,6,2,707,752
YDR222W,38,6,3,741,779
YDR222W,24,6,4,997,1021
YDR222W,41,6,5,1126,1167
YDR222W,22,6,6,1188,1210
YBL067C,18,5,1,1105,1123
YBL067C,28,5,2,1874,1902
YBL067C,19,5,3,1931,1950
YBL067C,16,5,4,2092,2108
YBL067C,28,5,5,2125,2153
YHR098C,78,15,1,792,870
YHR098C,23,15,2,1037,1060
YHR098C,31,15,3,1085,1116
YHR098C,16,15,4,1142,1158
YHR098C,17,15,5,1176,1193
YHR098C,15,15,6,1242,1257
YHR098C,31,15,7,1266,1297
YHR098C,15,15,8,1839,1854
YHR098C,36,15,9,2030,2066
YHR098C,51,15,10,2068,2119
YHR098C,55,15,11,2345,2400
YHR098C,76,15,12,2408,2484
YHR098C,15,15,13,2668,2683
YHR098C,32,15,14,2672,2704
YHR098C,29,15,15,2732,2761
YDL019C,16,16,1,194,210
YDL019C,26,16,2,1473,1499
YDL019C,24,16,3,1500,1524
YDL019C,20,16,4,2439,2459
YDL019C,18,16,5,2614,2632
YDL019C,18,16,6,2642,2660
YDL019C,32,16,7,2703,2735
YDL019C,28,16,8,2736,2764
YDL019C,54,16,9,2768,2822
YDL019C,16,16,10,3060,3076
YDL019C,66,16,11,3229,3295
YDL019C,19,16,12,3334,3353
YDL019C,18,16,13,3354,3372
YDL019C,29,16,14,3400,3429
YDL019C,19,16,15,3521,3540
YDL019C,15,16,16,3719,3734
YDL135C,23,2,1,212,235
YDL135C,32,2,2,577,609
YPR023C,18,3,1,230,248
YPR023C,85,3,2,269,354
YPR023C,27,3,3,429,456
YOR035C,23,8,1,400,423
YOR035C,15,8,2,617,632
YOR035C,21,8,3,634,655
YOR035C,24,8,4,745,769
YOR035C,45,8,5,888,933
YOR035C,27,8,6,1046,1073
YOR035C,17,8,7,1144,1161
YOR035C,15,8,8,2175,2190
YCR093W,36,12,1,853,889
YCR093W,20,12,2,969,989
YCR093W,22,12,3,1036,1058
YCR093W,30,12,4,1047,1077
YCR093W,30,12,5,1374,1404
YCR093W,19,12,6,2244,2263
YCR093W,37,12,7,2279,2316
YCR093W,19,12,8,3060,3079
YCR093W,18,12,9,3083,3101
YCR093W,18,12,10,3504,3522
YCR093W,19,12,11,3523,3542
YCR093W,18,12,12,4618,4636
YLR144C,19,10,1,921,940
YLR144C,28,10,2,1444,1472
YLR144C,21,10,3,1494,1515
YLR144C,16,10,4,1522,1538
YLR144C,23,10,5,1555,1578
YLR144C,18,10,6,1806,1824
YLR144C,49,10,7,1980,2029
YLR144C,18,10,8,2033,2051
YLR144C,35,10,9,2092,2127
YLR144C,31,10,10,2289,2320
YKR059W,41,7,1,284,325
YKR059W,28,7,2,388,416
YKR059W,43,7,3,703,746
YKR059W,63,7,4,748,811
YKR059W,32,7,5,920,952
YKR059W,17,7,6,953,970
YKR059W,22,7,7,973,995
YPR058W,91,3,1,283,374
YPR058W,72,3,2,555,627
YPR058W,41,3,3,872,913
YDL020C,83,6,1,257,340
YDL020C,31,6,2,398,429
YDL020C,45,6,3,576,621
YDL020C,21,6,4,912,933
YDL020C,44,6,5,1345,1389
YDL020C,46,6,6,1440,1486
YDR168W,58,1,1,1313,1371
YGL080W,15,1,1,365,380
YDL191W,19,2,1,153,172
YDL191W,37,2,2,232,269
YER023W,27,8,1,179,206
YER023W,46,8,2,217,263
YER023W,40,8,3,285,325
YER023W,26,8,4,377,403
YER023W,36,8,5,397,433
YER023W,38,8,6,518,556
YER023W,43,8,7,565,608
YER023W,49,8,8,767,816
YER163C,22,1,1,460,482
YBR069C,58,3,1,337,395
YBR069C,22,3,2,422,444
YBR069C,28,3,3,445,473
YML016C,28,7,1,1281,1309
YML016C,36,7,2,1304,1340
YML016C,15,7,3,1348,1363
YML016C,22,7,4,1628,1650
YML016C,18,7,5,1776,1794
YML016C,32,7,6,1784,1816
YML016C,35,7,7,1951,1986
YGR077C,16,4,1,221,237
YGR077C,26,4,2,559,585
YGR077C,16,4,3,748,764
YGR077C,55,4,4,1309,1364
YLR133W,59,6,1,399,458
YLR133W,58,6,2,523,581
YLR133W,66,6,3,583,649
YLR133W,27,6,4,672,699
YLR133W,16,6,5,748,764
YLR133W,18,6,6,1055,1073
YHR077C,28,3,1,931,959
YHR077C,36,3,2,2372,2408
YHR077C,19,3,3,2594,2613
YLR033W,75,6,1,212,287
YLR033W,19,6,2,301,320
YLR033W,17,6,3,577,594
YLR033W,48,6,4,712,760
YLR033W,24,6,5,1013,1037
YLR033W,40,6,6,1062,1102
YGR255C,23,5,1,404,427
YGR255C,37,5,2,568,605
YGR255C,30,5,3,945,975
YGR255C,31,5,4,1121,1152
YGR255C,18,5,5,1203,1221
YGL110C,19,3,1,568,587
YGL110C,22,3,2,1168,1190
YGL110C,16,3,3,1411,1427
YDL051W,36,3,1,200,236
YDL051W,34,3,2,361,395
YDL051W,121,3,3,592,713
YKL074C,60,6,1,177,237
YKL074C,16,6,2,807,823
YKL074C,15,6,3,1188,1203
YKL074C,47,6,4,1250,1297
YKL074C,15,6,5,1299,1314
YKL074C,18,6,6,1344,1362
YBL102W,15,1,1,436,451
YMR242C,18,1,1,251,269
YGL044C,30,1,1,322,352
YLR120C,42,2,1,250,292
YLR120C,21,2,2,316,337
YOR236W,26,5,1,280,306
YOR236W,18,5,2,308,326
YOR236W,37,5,3,330,367
YOR236W,29,5,4,355,384
YOR236W,24,5,5,532,556
YPL183C,52,18,1,170,222
YPL183C,71,18,2,233,304
YPL183C,45,18,3,528,573
YPL183C,29,18,4,735,764
YPL183C,29,18,5,995,1024
YPL183C,18,18,6,1515,1533
YPL183C,22,18,7,1699,1721
YPL183C,22,18,8,1746,1768
YPL183C,19,18,9,2269,2288
YPL183C,50,18,10,2475,2525
YPL183C,27,18,11,2549,2576
YPL183C,25,18,12,2595,2620
YPL183C,33,18,13,2622,2655
YPL183C,22,18,14,2657,2679
YPL183C,15,18,15,2790,2805
YPL183C,16,18,16,2807,2823
YPL183C,51,18,17,2927,2978
YPL183C,25,18,18,2984,3009
YDR166C,30,7,1,628,658
YDR166C,16,7,2,777,793
YDR166C,25,7,3,1726,1751
YDR166C,23,7,4,1752,1775
YDR166C,18,7,5,1778,1796
YDR166C,21,7,6,2604,2625
YDR166C,17,7,7,2729,2746
YPR118W,30,7,1,181,211
YPR118W,18,7,2,232,250
YPR118W,28,7,3,367,395
YPR118W,31,7,4,382,413
YPR118W,42,7,5,414,456
YPR118W,31,7,6,458,489
YPR118W,50,7,7,825,875
YBR198C,22,7,1,975,997
YBR198C,66,7,2,1782,1848
YBR198C,47,7,3,1908,1955
YBR198C,53,7,4,2045,2098
YBR198C,36,7,5,2118,2154
YBR198C,17,7,6,2265,2282
YBR198C,20,7,7,2283,2303
YGR204W,25,20,1,286,311
YGR204W,42,20,2,451,493
YGR204W,19,20,3,570,589
YGR204W,34,20,4,704,738
YGR204W,29,20,5,725,754
YGR204W,40,20,6,858,898
YGR204W,41,20,7,888,929
YGR204W,23,20,8,1239,1262
YGR204W,131,20,9,1561,1692
YGR204W,36,20,10,1693,1729
YGR204W,16,20,11,1730,1746
YGR204W,37,20,12,1748,1785
YGR204W,31,20,13,1809,1840
YGR204W,15,20,14,1884,1899
YGR204W,21,20,15,1904,1925
YGR204W,42,20,16,1927,1969
YGR204W,57,20,17,2098,2155
YGR204W,46,20,18,2208,2254
YGR204W,27,20,19,2392,2419
YGR204W,48,20,20,2792,2840
YJL050W,18,17,1,368,386
YJL050W,56,17,2,460,516
YJL050W,45,17,3,733,778
YJL050W,83,17,4,817,900
YJL050W,22,17,5,907,929
YJL050W,21,17,6,1091,1112
YJL050W,34,17,7,1391,1425
YJL050W,17,17,8,1542,1559
YJL050W,16,17,9,1580,1596
YJL050W,54,17,10,1670,1724
YJL050W,61,17,11,2062,2123
YJL050W,68,17,12,2319,2387
YJL050W,25,17,13,2394,2419
YJL050W,75,17,14,2423,2498
YJL050W,43,17,15,2761,2804
YJL050W,35,17,16,2958,2993
YJL050W,39,17,17,2981,3020
YDR146C,45,9,1,1083,1128
YDR146C,24,9,2,1153,1177
YDR146C,21,9,3,1266,1287
YDR146C,20,9,4,1325,1345
YDR146C,16,9,5,1346,1362
YDR146C,19,9,6,1661,1680
YDR146C,17,9,7,1735,1752
YDR146C,44,9,8,1741,1785
YDR146C,21,9,9,1850,1871
YBR112C,39,5,1,427,466
YBR112C,53,5,2,572,625
YBR112C,16,5,3,965,981
YBR112C,26,5,4,1323,1349
YBR112C,39,5,5,2862,2901
YDR248C,25,1,1,410,435
YJR016C,204,9,1,180,384
YJR016C,24,9,2,426,450
YJR016C,24,9,3,867,891
YJR016C,65,9,4,998,1063
YJR016C,35,9,5,1204,1239
YJR016C,66,9,6,1299,1365
YJR016C,49,9,7,1373,1422
YJR016C,76,9,8,1428,1504
YJR016C,56,9,9,1553,1609
YDL202W,15,2,1,264,279
YDL202W,31,2,2,493,524
YDL100C,23,2,1,679,702
YDL100C,81,2,2,982,1063
YFL008W,16,2,1,565,581
YFL008W,33,2,2,2394,2427
YJL061W,17,4,1,429,446
YJL061W,20,4,2,851,871
YJL061W,37,4,3,1233,1270
YJL061W,15,4,4,1876,1891
YLR216C,17,2,1,891,908
YLR216C,20,2,2,969,989
YPR147C,19,3,1,192,211
YPR147C,25,3,2,212,237
YPR147C,53,3,3,525,578
YGR063C,40,1,1,269,309
YPL023C,39,2,1,1516,1555
YPL023C,33,2,2,1770,1803
YIL123W,28,4,1,148,176
YIL123W,86,4,2,224,310
YIL123W,60,4,3,923,983
YIL123W,55,4,4,1140,1195
YOR231W,29,3,1,836,865
YOR231W,111,3,2,881,992
YOR231W,18,3,3,1412,1430
YMR035W,28,1,1,321,349
YPR161C,46,10,1,298,344
YPR161C,23,10,2,358,381
YPR161C,28,10,3,386,414
YPR161C,20,10,4,422,442
YPR161C,84,10,5,443,527
YPR161C,34,10,6,711,745
YPR161C,59,10,7,768,827
YPR161C,16,10,8,852,868
YPR161C,45,10,9,871,916
YPR161C,18,10,10,1403,1421
YKL117W,34,2,1,292,326
YKL117W,99,2,2,374,473
YDR062W,64,2,1,236,300
YDR062W,28,2,2,1618,1646
YML058W,32,3,1,190,222
YML058W,33,3,2,230,263
YML058W,25,3,3,277,302
YJR076C,45,3,1,321,366
YJR076C,48,3,2,529,577
YJR076C,15,3,3,946,961
YHR190W,46,6,1,190,236
YHR190W,94,6,2,283,377
YHR190W,20,6,3,484,504
YHR190W,37,6,4,565,602
YHR190W,38,6,5,1083,1121
YHR190W,77,6,6,1168,1245
YLR106C,15,30,1,670,685
YLR106C,21,30,2,1180,1201
YLR106C,28,30,3,1424,1452
YLR106C,35,30,4,1938,1973
YLR106C,17,30,5,2363,2380
YLR106C,29,30,6,2795,2824
YLR106C,29,30,7,3070,3099
YLR106C,28,30,8,3212,3240
YLR106C,21,30,9,3246,3267
YLR106C,15,30,10,3348,3363
YLR106C,25,30,11,3373,3398
YLR106C,23,30,12,3458,3481
YLR106C,30,30,13,3469,3499
YLR106C,25,30,14,3935,3960
YLR106C,15,30,15,4033,4048
YLR106C,55,30,16,4049,4104
YLR106C,24,30,17,5747,5771
YLR106C,23,30,18,5910,5933
YLR106C,22,30,19,6160,6182
YLR106C,19,30,20,6193,6212
YLR106C,24,30,21,6796,6820
YLR106C,34,30,22,7153,7187
YLR106C,18,30,23,7284,7302
YLR106C,19,30,24,7810,7829
YLR106C,17,30,25,9515,9532
YLR106C,18,30,26,9588,9606
YLR106C,16,30,27,10565,10581
YLR106C,17,30,28,10820,10837
YLR106C,28,30,29,10938,10966
YLR106C,23,30,30,14112,14135
YKL157W,75,5,1,637,712
YKL157W,47,5,2,939,986
YKL157W,56,5,3,1218,1274
YKL157W,25,5,4,1918,1943
YKL157W,43,5,5,2466,2509
YKR002W,17,15,1,432,449
YKR002W,35,15,2,678,713
YKR002W,29,15,3,866,895
YKR002W,41,15,4,957,998
YKR002W,44,15,5,999,1043
YKR002W,29,15,6,1107,1136
YKR002W,16,15,7,1148,1164
YKR002W,50,15,8,1265,1315
YKR002W,29,15,9,1326,1355
YKR002W,30,15,10,1357,1387
YKR002W,22,15,11,1388,1410
YKR002W,32,15,12,1468,1500
YKR002W,44,15,13,1534,1578
YKR002W,86,15,14,1603,1689
YKR002W,29,15,15,1677,1706
YBR003W,20,3,1,234,254
YBR003W,22,3,2,256,278
YBR003W,32,3,3,384,416
YDR200C,62,2,1,682,744
YDR200C,15,2,2,900,915
YPR105C,17,1,1,1031,1048
YPR129W,25,1,1,255,280
YOR130C,42,3,1,230,272
YOR130C,17,3,2,372,389
YOR130C,22,3,3,528,550
YLR201C,39,1,1,229,268
YBR130C,23,4,1,803,826
YBR130C,97,4,2,1082,1179
YBR130C,51,4,3,1173,1224
YBR130C,27,4,4,1251,1278
YLR274W,15,6,1,1091,1106
YLR274W,19,6,2,1114,1133
YLR274W,32,6,3,1209,1241
YLR274W,24,6,4,1440,1464
YLR274W,126,6,5,1942,2068
YLR274W,46,6,6,2156,2202
YBR247C,23,9,1,834,857
YBR247C,30,9,2,866,896
YBR247C,15,9,3,1110,1125
YBR247C,24,9,4,1197,1221
YBR247C,16,9,5,1255,1271
YBR247C,26,9,6,1295,1321
YBR247C,16,9,7,1334,1350
YBR247C,23,9,8,1366,1389
YBR247C,24,9,9,1391,1415
YLR369W,60,4,1,224,284
YLR369W,47,4,2,496,543
YLR369W,18,4,3,562,580
YLR369W,39,4,4,887,926
YIL154C,16,3,1,407,423
YIL154C,17,3,2,589,606
YIL154C,23,3,3,708,731
YOR007C,40,2,1,638,678
YOR007C,34,2,2,701,735
YBR165W,23,1,1,212,235
YOL148C,22,3,1,577,599
YOL148C,57,3,2,787,844
YOL148C,18,3,3,851,869
YPR082C,32,2,1,164,196
YPR082C,18,2,2,378,396
YPL154C,75,3,1,195,270
YPL154C,49,3,2,756,805
YPL154C,22,3,3,815,837
YHR019C,33,6,1,265,298
YHR019C,44,6,2,663,707
YHR019C,23,6,3,910,933
YHR019C,53,6,4,1231,1284
YHR019C,36,6,5,1461,1497
YHR019C,21,6,6,1515,1536
YAL003W,83,2,1,497,580
YAL003W,23,2,2,585,608
YPL101W,19,1,1,1106,1125
YNR015W,15,5,1,572,587
YNR015W,40,5,2,579,619
YNR015W,43,5,3,620,663
YNR015W,32,5,4,943,975
YNR015W,21,5,5,976,997
YIL078W,17,10,1,214,231
YIL078W,48,10,2,671,719
YIL078W,52,10,3,850,902
YIL078W,22,10,4,941,963
YIL078W,36,10,5,966,1002
YIL078W,31,10,6,1295,1326
YIL078W,65,10,7,1510,1575
YIL078W,26,10,8,1652,1678
YIL078W,48,10,9,2033,2081
YIL078W,60,10,10,2141,2201
YGL009C,51,13,1,442,493
YGL009C,34,13,2,954,988
YGL009C,50,13,3,1090,1140
YGL009C,45,13,4,1135,1180
YGL009C,105,13,5,1230,1335
YGL009C,44,13,6,1336,1380
YGL009C,37,13,7,1469,1506
YGL009C,43,13,8,1544,1587
YGL009C,20,13,9,1670,1690
YGL009C,58,13,10,1826,1884
YGL009C,17,13,11,1963,1980
YGL009C,50,13,12,2058,2108
YGL009C,99,13,13,2153,2252
YGR163W,18,1,1,460,478
YKL022C,28,2,1,2082,2110
YKL022C,19,2,2,2207,2226
YIL130W,24,3,1,903,927
YIL130W,33,3,2,1201,1234
YIL130W,33,3,3,1253,1286
YDR368W,54,6,1,354,408
YDR368W,55,6,2,484,539
YDR368W,25,6,3,611,636
YDR368W,48,6,4,680,728
YDR368W,44,6,5,755,799
YDR368W,53,6,6,886,939
YBR101C,43,1,1,369,412
YLR147C,39,1,1,249,288
YDL164C,15,8,1,285,300
YDL164C,26,8,2,313,339
YDL164C,45,8,3,822,867
YDL164C,39,8,4,909,948
YDL164C,15,8,5,1038,1053
YDL164C,42,8,6,1260,1302
YDL164C,28,8,7,1935,1963
YDL164C,21,8,8,2055,2076
YJR050W,19,4,1,263,282
YJR050W,32,4,2,327,359
YJR050W,50,4,3,612,662
YJR050W,21,4,4,667,688
YDR177W,40,2,1,341,381
YDR177W,28,2,2,546,574
YGR161C,18,4,1,216,234
YGR161C,25,4,2,242,267
YGR161C,70,4,3,432,502
YGR161C,15,4,4,752,767
YIR001C,29,1,1,180,209
YBR149W,26,5,1,307,333
YBR149W,43,5,2,421,464
YBR149W,68,5,3,571,639
YBR149W,34,5,4,705,739
YBR149W,51,5,5,740,791
YGL210W,62,3,1,327,389
YGL210W,18,3,2,457,475
YGL210W,20,3,3,539,559
YPR110C,96,1,1,704,800
YDR088C,31,5,1,480,511
YDR088C,21,5,2,624,645
YDR088C,41,5,3,647,688
YDR088C,37,5,4,679,716
YDR088C,46,5,5,741,787
YNL066W,37,4,1,268,305
YNL066W,49,4,2,755,804
YNL066W,28,4,3,1002,1030
YNL066W,60,4,4,1031,1091
YPL112C,36,2,1,647,683
YPL112C,26,2,2,684,710
YPL030W,48,5,1,263,311
YPL030W,27,5,2,338,365
YPL030W,74,5,3,624,698
YPL030W,18,5,4,977,995
YPL030W,44,5,5,1251,1295
YKL013C,159,3,1,141,300
YKL013C,56,3,2,338,394
YKL013C,43,3,3,395,438
YKL101W,25,10,1,1826,1851
YKL101W,32,10,2,1845,1877
YKL101W,25,10,3,3722,3747
YKL101W,38,10,4,3771,3809
YKL101W,15,10,5,3812,3827
YKL101W,17,10,6,3863,3880
YKL101W,27,10,7,4249,4276
YKL101W,50,10,8,4322,4372
YKL101W,29,10,9,4403,4432
YKL101W,32,10,10,4493,4525
YNL124W,16,3,1,691,707
YNL124W,43,3,2,709,752
YNL124W,17,3,3,765,782
YIL094C,46,4,1,254,300
YIL094C,46,4,2,462,508
YIL094C,35,4,3,748,783
YIL094C,21,4,4,998,1019
YIL016W,55,1,1,209,264
YJL098W,27,5,1,716,743
YJL098W,27,5,2,749,776
YJL098W,23,5,3,2375,2398
YJL098W,17,5,4,2660,2677
YJL098W,18,5,5,2687,2705
YIL076W,36,1,1,827,863
YOL044W,35,2,1,552,587
YOL044W,15,2,2,717,732
YOL028C,50,1,1,597,647
YDR186C,19,4,1,237,256
YDR186C,22,4,2,1140,1162
YDR186C,42,4,3,1436,1478
YDR186C,28,4,4,1757,1785
YDL213C,54,1,1,443,497
YBL038W,52,3,1,448,500
YBL038W,50,3,2,507,557
YBL038W,58,3,3,560,618
YML117W,24,7,1,2210,2234
YML117W,41,7,2,2237,2278
YML117W,71,7,3,2617,2688
YML117W,19,7,4,2689,2708
YML117W,17,7,5,2845,2862
YML117W,16,7,6,2944,2960
YML117W,16,7,7,3097,3113
YGR054W,49,7,1,431,480
YGR054W,21,7,2,566,587
YGR054W,72,7,3,798,870
YGR054W,72,7,4,1324,1396
YGR054W,18,7,5,1692,1710
YGR054W,30,7,6,1717,1747
YGR054W,19,7,7,1895,1914
YGR189C,54,1,1,403,457
YOR332W,21,2,1,242,263
YOR332W,20,2,2,394,414
YOR069W,19,3,1,946,965
YOR069W,18,3,2,978,996
YOR069W,26,3,3,1138,1164
YGR038W,35,2,1,195,230
YGR038W,19,2,2,231,250
YNL087W,47,3,1,899,946
YNL087W,28,3,2,2862,2890
YNL087W,21,3,3,3284,3305
YKL019W,33,3,1,375,408
YKL019W,29,3,2,526,555
YKL019W,41,3,3,683,724
YBR278W,25,2,1,321,346
YBR278W,26,2,2,368,394
YFR055W,16,4,1,557,573
YFR055W,24,4,2,576,600
YFR055W,45,4,3,811,856
YFR055W,31,4,4,857,888
YOR067C,45,1,1,177,222
YDR296W,82,1,1,408,490
YGL232W,56,3,1,481,537
YGL232W,32,3,2,586,618
YGL232W,28,3,3,740,768
YPR091C,54,2,1,435,489
YPR091C,23,2,2,530,553
YOR109W,34,7,1,368,402
YOR109W,61,7,2,1715,1776
YOR109W,19,7,3,1777,1796
YOR109W,34,7,4,1787,1821
YOR109W,18,7,5,2679,2697
YOR109W,45,7,6,2684,2729
YOR109W,24,7,7,2740,2764
YKL060C,60,1,1,596,656
YIL116W,28,9,1,457,485
YIL116W,24,9,2,494,518
YIL116W,19,9,3,560,579
YIL116W,28,9,4,604,632
YIL116W,27,9,5,722,749
YIL116W,15,9,6,794,809
YIL116W,54,9,7,811,865
YIL116W,44,9,8,937,981
YIL116W,31,9,9,969,1000
YGR094W,33,12,1,655,688
YGR094W,31,12,2,744,775
YGR094W,30,12,3,785,815
YGR094W,56,12,4,858,914
YGR094W,48,12,5,944,992
YGR094W,46,12,6,1037,1083
YGR094W,64,12,7,1127,1191
YGR094W,23,12,8,1456,1479
YGR094W,30,12,9,1595,1625
YGR094W,42,12,10,1763,1805
YGR094W,57,12,11,1961,2018
YGR094W,23,12,12,2223,2246
YHR064C,30,4,1,443,473
YHR064C,15,4,2,556,571
YHR064C,59,4,3,903,962
YHR064C,29,4,4,1433,1462
YJR103W,19,9,1,487,506
YJR103W,21,9,2,509,530
YJR103W,19,9,3,783,802
YJR103W,24,9,4,1136,1160
YJR103W,19,9,5,1467,1486
YJR103W,18,9,6,1536,1554
YJR103W,48,9,7,1542,1590
YJR103W,28,9,8,1611,1639
YJR103W,21,9,9,1696,1717
YGR156W,16,1,1,279,295
YBL007C,18,6,1,355,373
YBL007C,19,6,2,779,798
YBL007C,34,6,3,799,833
YBL007C,38,6,4,1624,1662
YBL007C,43,6,5,1651,1694
YBL007C,29,6,6,1965,1994
YMR307W,27,1,1,488,515
YAL032C,36,3,1,349,385
YAL032C,24,3,2,960,984
YAL032C,19,3,3,986,1005
YGL145W,18,5,1,723,741
YGL145W,18,5,2,752,770
YGL145W,19,5,3,862,881
YGL145W,40,5,4,980,1020
YGL145W,19,5,5,1323,1342
YOR021C,35,2,1,365,400
YOR021C,16,2,2,401,417
YNL252C,25,2,1,291,316
YNL252C,18,2,2,565,583
YKL021C,29,3,1,517,546
YKL021C,31,3,2,680,711
YKL021C,43,3,3,712,755
YER133W,16,3,1,470,486
YER133W,51,3,2,544,595
YER133W,17,3,3,922,939
YGL248W,16,2,1,690,706
YGL248W,25,2,2,730,755
YOL006C,23,12,1,453,476
YOL006C,70,12,2,547,617
YOL006C,56,12,3,618,674
YOL006C,29,12,4,995,1024
YOL006C,29,12,5,1228,1257
YOL006C,59,12,6,1442,1501
YOL006C,20,12,7,1516,1536
YOL006C,31,12,8,1905,1936
YOL006C,25,12,9,1941,1966
YOL006C,31,12,10,2037,2068
YOL006C,34,12,11,2098,2132
YOL006C,23,12,12,2237,2260
YER020W,32,2,1,588,620
YER020W,18,2,2,1210,1228
YNL201C,48,7,1,216,264
YNL201C,59,7,2,571,630
YNL201C,42,7,3,618,660
YNL201C,26,7,4,1016,1042
YNL201C,18,7,5,1826,1844
YNL201C,15,7,6,1847,1862
YNL201C,71,7,7,2271,2342
YCR028C-A,41,1,1,344,385
YGR076C,33,2,1,290,323
YGR076C,21,2,2,342,363
YER075C,29,9,1,475,504
YER075C,21,9,2,505,526
YER075C,34,9,3,1454,1488
YER075C,35,9,4,2175,2210
YER075C,21,9,5,2412,2433
YER075C,33,9,6,2571,2604
YER075C,37,9,7,2646,2683
YER075C,16,9,8,2684,2700
YER075C,15,9,9,2737,2752
YEL015W,33,8,1,265,298
YEL015W,31,8,2,285,316
YEL015W,32,8,3,947,979
YEL015W,15,8,4,980,995
YEL015W,48,8,5,1108,1156
YEL015W,33,8,6,1163,1196
YEL015W,24,8,7,1286,1310
YEL015W,16,8,8,1518,1534
YEL040W,19,4,1,472,491
YEL040W,46,4,2,537,583
YEL040W,19,4,3,655,674
YEL040W,46,4,4,980,1026
YKR085C,28,1,1,473,501
YLR418C,29,4,1,329,358
YLR418C,25,4,2,1068,1093
YLR418C,18,4,3,1131,1149
YLR418C,23,4,4,1152,1175
YLR063W,18,1,1,397,415
YER059W,48,5,1,472,520
YER059W,21,5,2,709,730
YER059W,41,5,3,718,759
YER059W,15,5,4,777,792
YER059W,56,5,5,923,979
YGL111W,39,6,1,227,266
YGL111W,32,6,2,272,304
YGL111W,38,6,3,585,623
YGL111W,15,6,4,651,666
YGL111W,40,6,5,699,739
YGL111W,41,6,6,1299,1340
YNL110C,24,1,1,516,540
YBR289W,27,1,1,1459,1486
YBL025W,24,3,1,325,349
YBL025W,31,3,2,368,399
YBL025W,30,3,3,394,424
YPL048W,113,7,1,159,272
YPL048W,29,7,2,275,304
YPL048W,20,7,3,382,402
YPL048W,25,7,4,440,465
YPL048W,126,7,5,977,1103
YPL048W,35,7,6,1165,1200
YPL048W,33,7,7,1204,1237
YOL066C,22,4,1,220,242
YOL066C,21,4,2,279,300
YOL066C,19,4,3,306,325
YOL066C,84,4,4,1027,1111
YPR133C,43,1,1,790,833
YKL212W,29,6,1,314,343
YKL212W,95,6,2,561,656
YKL212W,61,6,3,1157,1218
YKL212W,22,6,4,1394,1416
YKL212W,69,6,5,1667,1736
YKL212W,44,6,6,1737,1781
YGL167C,47,4,1,831,878
YGL167C,24,4,2,883,907
YGL167C,66,4,3,1598,1664
YGL167C,34,4,4,1665,1699
YHR115C,15,7,1,234,249
YHR115C,54,7,2,251,305
YHR115C,23,7,3,495,518
YHR115C,22,7,4,687,709
YHR115C,57,7,5,711,768
YHR115C,98,7,6,778,876
YHR115C,44,7,7,1171,1215
YER124C,25,8,1,791,816
YER124C,25,8,2,1001,1026
YER124C,27,8,3,1124,1151
YER124C,32,8,4,1280,1312
YER124C,47,8,5,1453,1500
YER124C,20,8,6,1589,1609
YER124C,25,8,7,1610,1635
YER124C,59,8,8,1636,1695
YEL022W,24,3,1,226,250
YEL022W,26,3,2,351,377
YEL022W,49,3,3,776,825
YIL053W,49,1,1,424,473
YDL074C,39,2,1,393,432
YDL074C,33,2,2,725,758
YOR374W,36,8,1,220,256
YOR374W,40,8,2,724,764
YOR374W,72,8,3,768,840
YOR374W,17,8,4,1330,1347
YOR374W,27,8,5,1352,1379
YOR374W,42,8,6,1395,1437
YOR374W,17,8,7,1451,1468
YOR374W,35,8,8,1479,1514
YJL190C,58,1,1,206,264
YKR084C,34,3,1,1235,1269
YKR084C,17,3,2,1547,1564
YKR084C,26,3,3,1566,1592
YLR052W,34,2,1,472,506
YLR052W,15,2,2,512,527
YGL107C,22,5,1,660,682
YGL107C,16,5,2,688,704
YGL107C,29,5,3,1297,1326
YGL107C,22,5,4,1537,1559
YGL107C,34,5,5,1568,1602
YOR212W,37,5,1,365,402
YOR212W,18,5,2,441,459
YOR212W,73,5,3,586,659
YOR212W,44,5,4,758,802
YOR212W,59,5,5,1154,1213
YPL256C,49,4,1,286,335
YPL256C,18,4,2,391,409
YPL256C,64,4,3,420,484
YPL256C,55,4,4,497,552
YER037W,20,1,1,650,670
YNL301C,113,1,1,222,335
YMR156C,27,1,1,430,457
YPL177C,21,6,1,279,300
YPL177C,24,6,2,334,358
YPL177C,38,6,3,365,403
YPL177C,18,6,4,584,602
YPL177C,34,6,5,766,800
YPL177C,32,6,6,846,878
YJL111W,139,12,1,217,356
YJL111W,30,12,2,358,388
YJL111W,180,12,3,395,575
YJL111W,75,12,4,580,655
YJL111W,21,12,5,659,680
YJL111W,44,12,6,710,754
YJL111W,21,12,7,788,809
YJL111W,50,12,8,835,885
YJL111W,90,12,9,1007,1097
YJL111W,71,12,10,1118,1189
YJL111W,46,12,11,1491,1537
YJL111W,24,12,12,1542,1566
YDR061W,21,3,1,629,650
YDR061W,35,3,2,1087,1122
YDR061W,33,3,3,1123,1156
YOR290C,23,10,1,931,954
YOR290C,19,10,2,1778,1797
YOR290C,59,10,3,1866,1925
YOR290C,21,10,4,2270,2291
YOR290C,33,10,5,2659,2692
YOR290C,20,10,6,2802,2822
YOR290C,21,10,7,3735,3756
YOR290C,48,10,8,3749,3797
YOR290C,28,10,9,4097,4125
YOR290C,19,10,10,4187,4206
YKL114C,36,2,1,260,296
YKL114C,37,2,2,531,568
YML024W,23,2,1,161,184
YML024W,40,2,2,342,382
YML093W,34,2,1,1809,1843
YML093W,22,2,2,2116,2138
YHR197W,25,3,1,670,695
YHR197W,27,3,2,1799,1826
YHR197W,33,3,3,2105,2138
YDL112W,24,18,1,316,340
YDL112W,22,18,2,427,449
YDL112W,37,18,3,450,487
YDL112W,27,18,4,1625,1652
YDL112W,19,18,5,1774,1793
YDL112W,30,18,6,1792,1822
YDL112W,19,18,7,2024,2043
YDL112W,25,18,8,2318,2343
YDL112W,46,18,9,2475,2521
YDL112W,34,18,10,2658,2692
YDL112W,27,18,11,2698,2725
YDL112W,51,18,12,2900,2951
YDL112W,45,18,13,3083,3128
YDL112W,61,18,14,3258,3319
YDL112W,15,18,15,3320,3335
YDL112W,21,18,16,3812,3833
YDL112W,16,18,17,3841,3857
YDL112W,41,18,18,3984,4025
YDR423C,30,2,1,632,662
YDR423C,26,2,2,1117,1143
YPR106W,16,3,1,742,758
YPR106W,15,3,2,868,883
YPR106W,31,3,3,1020,1051
YPR004C,20,11,1,194,214
YPR004C,22,11,2,216,238
YPR004C,19,11,3,443,462
YPR004C,140,11,4,483,623
YPR004C,21,11,5,628,649
YPR004C,54,11,6,675,729
YPR004C,23,11,7,730,753
YPR004C,20,11,8,764,784
YPR004C,35,11,9,771,806
YPR004C,19,11,10,807,826
YPR004C,57,11,11,950,1007
YGR261C,26,11,1,299,325
YGR261C,45,11,2,348,393
YGR261C,16,11,3,683,699
YGR261C,44,11,4,882,926
YGR261C,36,11,5,1372,1408
YGR261C,24,11,6,1426,1450
YGR261C,49,11,7,1755,1804
YGR261C,34,11,8,1903,1937
YGR261C,33,11,9,1959,1992
YGR261C,23,11,10,2001,2024
YGR261C,21,11,11,2405,2426
YKR003W,40,8,1,317,357
YKR003W,20,8,2,471,491
YKR003W,16,8,3,500,516
YKR003W,21,8,4,808,829
YKR003W,16,8,5,946,962
YKR003W,38,8,6,1073,1111
YKR003W,26,8,7,1252,1278
YKR003W,38,8,8,1307,1345
YDR158W,49,5,1,610,659
YDR158W,41,5,2,742,783
YDR158W,36,5,3,823,859
YDR158W,137,5,4,899,1036
YDR158W,46,5,5,1045,1091
YMR116C,19,4,1,546,565
YMR116C,29,4,2,597,626
YMR116C,72,4,3,651,723
YMR116C,28,4,4,932,960
YOL019W,29,2,1,1409,1438
YOL019W,21,2,2,1474,1495
YOR164C,81,4,1,153,234
YOR164C,28,4,2,236,264
YOR164C,45,4,3,266,311
YOR164C,19,4,4,433,452
YGR283C,29,2,1,511,540
YGR283C,31,2,2,599,630
YER175C,25,4,1,298,323
YER175C,15,4,2,513,528
YER175C,61,4,3,671,732
YER175C,26,4,4,778,804
YMR308C,29,4,1,321,350
YMR308C,43,4,2,1515,1558
YMR308C,32,4,3,1721,1753
YMR308C,38,4,4,2638,2676
YKL135C,23,7,1,469,492
YKL135C,16,7,2,602,618
YKL135C,20,7,3,895,915
YKL135C,32,7,4,940,972
YKL135C,19,7,5,1065,1084
YKL135C,23,7,6,1134,1157
YKL135C,32,7,7,1206,1238
YJL033W,32,4,1,261,293
YJL033W,24,4,2,1005,1029
YJL033W,19,4,3,1283,1302
YJL033W,48,4,4,1391,1439
YLR429W,35,6,1,352,387
YLR429W,44,6,2,511,555
YLR429W,173,6,3,613,786
YLR429W,19,6,4,868,887
YLR429W,29,6,5,1014,1043
YLR429W,47,6,6,1099,1146
YDR050C,21,3,1,257,278
YDR050C,42,3,2,390,432
YDR050C,33,3,3,600,633
YGR061C,33,17,1,452,485
YGR061C,16,17,2,506,522
YGR061C,57,17,3,870,927
YGR061C,26,17,4,1160,1186
YGR061C,24,17,5,1187,1211
YGR061C,15,17,6,1515,1530
YGR061C,39,17,7,1693,1732
YGR061C,43,17,8,1956,1999
YGR061C,20,17,9,2143,2163
YGR061C,45,17,10,2268,2313
YGR061C,42,17,11,2463,2505
YGR061C,32,17,12,2568,2600
YGR061C,17,17,13,3615,3632
YGR061C,27,17,14,3636,3663
YGR061C,147,17,15,3690,3837
YGR061C,89,17,16,3948,4037
YGR061C,36,17,17,4039,4075
YNL265C,24,5,1,196,220
YNL265C,17,5,2,418,435
YNL265C,15,5,3,525,540
YNL265C,18,5,4,542,560
YNL265C,54,5,5,824,878
YNL312W,15,2,1,273,288
YNL312W,23,2,2,544,567
YPL241C,44,1,1,672,716
YLR145W,33,3,1,343,376
YLR145W,18,3,2,379,397
YLR145W,43,3,3,438,481
YDR169C,35,4,1,946,981
YDR169C,31,4,2,971,1002
YDR169C,29,4,3,1030,1059
YDR169C,101,4,4,1288,1389
YMR183C,24,1,1,827,851
YIR038C,74,1,1,201,275
YDL134C,42,2,1,434,476
YDL134C,56,2,2,744,800
YEL071W,99,8,1,497,596
YEL071W,22,8,2,857,879
YEL071W,17,8,3,924,941
YEL071W,47,8,4,988,1035
YEL071W,26,8,5,1176,1202
YEL071W,70,8,6,1207,1277
YEL071W,30,8,7,1280,1310
YEL071W,44,8,8,1392,1436
YMR272C,32,1,1,405,437
YPR108W,41,7,1,292,333
YPR108W,16,7,2,441,457
YPR108W,36,7,3,674,710
YPR108W,45,7,4,773,818
YPR108W,16,7,5,860,876
YPR108W,42,7,6,1119,1161
YPR108W,19,7,7,1267,1286
YNL041C,37,5,1,617,654
YNL041C,29,5,2,1345,1374
YNL041C,70,5,3,1600,1670
YNL041C,21,5,4,2186,2207
YNL041C,39,5,5,2262,2301
YBL093C,69,6,1,288,357
YBL093C,43,6,2,361,404
YBL093C,40,6,3,411,451
YBL093C,41,6,4,461,502
YBL093C,32,6,5,510,542
YBL093C,120,6,6,543,663
YLR390W-A,36,4,1,276,312
YLR390W-A,23,4,2,483,506
YLR390W-A,18,4,3,509,527
YLR390W-A,141,4,4,560,701
YGR162W,16,4,1,592,608
YGR162W,38,4,2,771,809
YGR162W,22,4,3,904,926
YGR162W,42,4,4,1717,1759
YDL165W,43,1,1,461,504
YDR258C,34,5,1,507,541
YDR258C,31,5,2,868,899
YDR258C,30,5,3,886,916
YDR258C,89,5,4,1106,1195
YDR258C,96,5,5,1931,2027
YOR215C,68,4,1,166,234
YOR215C,24,4,2,240,264
YOR215C,35,4,3,293,328
YOR215C,27,4,4,352,379
YKL094W,64,2,1,264,328
YKL094W,29,2,2,806,835
YNL022C,21,3,1,240,261
YNL022C,28,3,2,447,475
YNL022C,54,3,3,489,543
YPR131C,52,4,1,362,414
YPR131C,31,4,2,408,439
YPR131C,85,4,3,471,556
YPR131C,20,4,4,557,577
YIL131C,19,7,1,269,288
YIL131C,22,7,2,295,317
YIL131C,35,7,3,332,367
YIL131C,23,7,4,1035,1058
YIL131C,19,7,5,1195,1214
YIL131C,24,7,6,1315,1339
YIL131C,18,7,7,1374,1392
YBR146W,30,2,1,275,305
YBR146W,23,2,2,308,331
YPL031C,47,8,1,188,235
YPL031C,16,8,2,253,269
YPL031C,31,8,3,276,307
YPL031C,31,8,4,295,326
YPL031C,26,8,5,332,358
YPL031C,17,8,6,466,483
YPL031C,84,8,7,522,606
YPL031C,37,8,8,639,676
YER080W,37,7,1,221,258
YER080W,38,7,2,552,590
YER080W,30,7,3,778,808
YER080W,15,7,4,1272,1287
YER080W,15,7,5,1298,1313
YER080W,16,7,6,1660,1676
YER080W,16,7,7,1691,1707
YJL164C,26,1,1,910,936
YJR019C,17,2,1,388,405
YJR019C,35,2,2,757,792
YDR321W,21,15,1,158,179
YDR321W,15,15,2,189,204
YDR321W,19,15,3,307,326
YDR321W,24,15,4,369,393
YDR321W,15,15,5,395,410
YDR321W,34,15,6,412,446
YDR321W,27,15,7,441,468
YDR321W,20,15,8,472,492
YDR321W,28,15,9,758,786
YDR321W,50,15,10,840,890
YDR321W,26,15,11,888,914
YDR321W,84,15,12,925,1009
YDR321W,32,15,13,996,1028
YDR321W,41,15,14,1070,1111
YDR321W,18,15,15,1122,1140
YNR001C,44,6,1,429,473
YNR001C,18,6,2,474,492
YNR001C,49,6,3,714,763
YNR001C,23,6,4,1025,1048
YNR001C,89,6,5,1164,1253
YNR001C,18,6,6,1255,1273
YNL178W,36,5,1,254,290
YNL178W,39,5,2,293,332
YNL178W,42,5,3,333,375
YNL178W,25,5,4,559,584
YNL178W,41,5,5,671,712
YDR147W,30,2,1,1003,1033
YDR147W,49,2,2,1354,1403
YMR076C,15,2,1,900,915
YMR076C,30,2,2,1398,1428
YGR205W,37,2,1,276,313
YGR205W,27,2,2,593,620
YDR356W,50,4,1,283,333
YDR356W,17,4,2,1430,1447
YDR356W,19,4,3,1869,1888
YDR356W,15,4,4,2021,2036
YDL083C,49,1,1,378,427
YPR174C,28,3,1,348,376
YPR174C,18,3,2,381,399
YPR174C,17,3,3,442,459
YJL060W,45,2,1,437,482
YJL060W,33,2,2,701,734
YDL101C,17,3,1,307,324
YDL101C,70,3,2,805,875
YDL101C,25,3,3,1326,1351
YDL205C,20,3,1,242,262
YDL205C,55,3,2,456,511
YDL205C,24,3,3,716,740
YML080W,28,6,1,697,725
YML080W,24,6,2,745,769
YML080W,47,6,3,1068,1115
YML080W,45,6,4,1133,1178
YML080W,19,6,5,1189,1208
YML080W,26,6,6,1244,1270
YNL327W,53,2,1,259,312
YNL327W,38,2,2,530,568
YHR216W,29,2,1,470,499
YHR216W,19,2,2,1529,1548
YDL230W,41,4,1,360,401
YDL230W,20,4,2,407,427
YDL230W,38,4,3,684,722
YDL230W,20,4,4,750,770
YPR166C,30,1,1,260,290
YJR113C,45,3,1,312,357
YJR113C,35,3,2,397,432
YJR113C,42,3,3,561,603
YBR279W,15,5,1,184,199
YBR279W,15,5,2,479,494
YBR279W,39,5,3,496,535
YBR279W,25,5,4,647,672
YBR279W,39,5,5,1139,1178
YOR281C,23,2,1,465,488
YOR281C,73,2,2,590,663
YIL117C,27,1,1,750,777
YHR041C,44,2,1,240,284
YHR041C,33,2,2,318,351
YOL052C,21,2,1,629,650
YOL052C,18,2,2,651,669
YKL032C,36,2,1,851,887
YKL032C,57,2,2,1469,1526
YOR122C,72,1,1,192,264
YBR151W,36,5,1,299,335
YBR151W,52,5,2,391,443
YBR151W,32,5,3,775,807
YBR151W,19,5,4,890,909
YBR151W,15,5,5,929,944
YNR034W,17,2,1,522,539
YNR034W,22,2,2,886,908
YGL231C,42,1,1,345,387
YNL282W,66,2,1,356,422
YNL282W,20,2,2,510,530
YBR286W,28,2,1,192,220
YBR286W,29,2,2,364,393
YJL165C,16,3,1,588,604
YJL165C,32,3,2,870,902
YJL165C,31,3,3,2359,2390
YDR297W,17,2,1,224,241
YDR297W,29,2,2,243,272
YML070W,29,8,1,172,201
YML070W,45,8,2,394,439
YML070W,18,8,3,723,741
YML070W,16,8,4,867,883
YML070W,22,8,5,1062,1084
YML070W,25,8,6,1249,1274
YML070W,28,8,7,1282,1310
YML070W,85,8,8,1543,1628
YBL006C,26,1,1,472,498
YLR340W,67,5,1,169,236
YLR340W,49,5,2,277,326
YLR340W,26,5,3,442,468
YLR340W,21,5,4,809,830
YLR340W,16,5,5,840,856
YGR108W,51,5,1,812,863
YGR108W,21,5,2,1204,1225
YGR108W,20,5,3,1301,1321
YGR108W,21,5,4,1360,1381
YGR108W,32,5,5,1382,1414
YBR231C,18,1,1,743,761
YHR162W,57,3,1,142,199
YHR162W,117,3,2,210,327
YHR162W,55,3,3,328,383
YBR246W,42,5,1,385,427
YBR246W,25,5,2,707,732
YBR246W,43,5,3,815,858
YBR246W,16,5,4,879,895
YBR246W,24,5,5,1115,1139
YPL110C,29,13,1,891,920
YPL110C,28,13,2,1114,1142
YPL110C,24,13,3,1347,1371
YPL110C,22,13,4,1382,1404
YPL110C,26,13,5,1666,1692
YPL110C,33,13,6,1812,1845
YPL110C,20,13,7,2178,2198
YPL110C,18,13,8,3143,3161
YPL110C,18,13,9,3273,3291
YPL110C,17,13,10,3308,3325
YPL110C,19,13,11,3493,3512
YPL110C,43,13,12,3521,3564
YPL110C,21,13,13,3600,3621
YGR207C,235,5,1,183,418
YGR207C,31,5,2,506,537
YGR207C,35,5,3,540,575
YGR207C,47,5,4,671,718
YGR207C,52,5,5,720,772
YLR275W,40,1,1,293,333
YDR212W,43,13,1,517,560
YDR212W,99,13,2,720,819
YDR212W,91,13,3,807,898
YDR212W,17,13,4,930,947
YDR212W,30,13,5,935,965
YDR212W,25,13,6,1049,1074
YDR212W,50,13,7,1073,1123
YDR212W,26,13,8,1247,1273
YDR212W,26,13,9,1279,1305
YDR212W,41,13,10,1483,1524
YDR212W,23,13,11,1552,1575
YDR212W,19,13,12,1580,1599
YDR212W,32,13,13,1611,1643
YLR186W,24,3,1,153,177
YLR186W,24,3,2,629,653
YLR186W,37,3,3,681,718
YKL043W,171,10,1,332,503
YKL043W,18,10,2,513,531
YKL043W,92,10,3,539,631
YKL043W,85,10,4,663,748
YKL043W,42,10,5,830,872
YKL043W,19,10,6,885,904
YKL043W,24,10,7,941,965
YKL043W,15,10,8,970,985
YKL043W,29,10,9,987,1016
YKL043W,30,10,10,1049,1079
YIL155C,18,2,1,680,698
YIL155C,36,2,2,762,798
YDL227C,21,8,1,407,428
YDL227C,21,8,2,528,549
YDL227C,19,8,3,762,781
YDL227C,36,8,4,943,979
YDL227C,20,8,5,1000,1020
YDL227C,18,8,6,1024,1042
YDL227C,19,8,7,1058,1077
YDL227C,29,8,8,1647,1676
YPL055C,26,1,1,539,565
YAL013W,18,3,1,768,786
YAL013W,21,3,2,833,854
YAL013W,37,3,3,944,981
YDR098C,23,6,1,301,324
YDR098C,41,6,2,332,373
YDR098C,56,6,3,467,523
YDR098C,54,6,4,713,767
YDR098C,16,6,5,773,789
YDR098C,16,6,6,819,835
YOR371C,30,7,1,482,512
YOR371C,19,7,2,685,704
YOR371C,32,7,3,1435,1467
YOR371C,38,7,4,1506,1544
YOR371C,23,7,5,1984,2007
YOR371C,24,7,6,2259,2283
YOR371C,15,7,7,2358,2373
YPL009C,49,6,1,357,406
YPL009C,67,6,2,684,751
YPL009C,29,6,3,1833,1862
YPL009C,34,6,4,2692,2726
YPL009C,37,6,5,2721,2758
YPL009C,21,6,6,2992,3013
YGL200C,46,1,1,390,436
YJR099W,17,3,1,168,185
YJR099W,46,3,2,214,260
YJR099W,33,3,3,281,314
YLR259C,108,10,1,191,299
YLR259C,18,10,2,315,333
YLR259C,26,10,3,719,745
YLR259C,93,10,4,795,888
YLR259C,52,10,5,935,987
YLR259C,66,10,6,999,1065
YLR259C,137,10,7,1169,1306
YLR259C,64,10,8,1445,1509
YLR259C,16,10,9,1520,1536
YLR259C,34,10,10,1628,1662
YNL052W,69,3,1,191,260
YNL052W,67,3,2,247,314
YNL052W,19,3,3,356,375
YBR120C,21,1,1,467,488
YLR085C,20,2,1,1142,1162
YLR085C,36,2,2,1257,1293
YDR280W,38,5,1,302,340
YDR280W,16,5,2,509,525
YDR280W,21,5,3,535,556
YDR280W,37,5,4,683,720
YDR280W,26,5,5,725,751
YKL215C,20,36,1,280,300
YKL215C,30,36,2,423,453
YKL215C,34,36,3,501,535
YKL215C,42,36,4,529,571
YKL215C,27,36,5,606,633
YKL215C,18,36,6,651,669
YKL215C,22,36,7,715,737
YKL215C,15,36,8,825,840
YKL215C,26,36,9,1310,1336
YKL215C,46,36,10,1372,1418
YKL215C,22,36,11,1449,1471
YKL215C,31,36,12,1460,1491
YKL215C,23,36,13,1521,1544
YKL215C,22,36,14,1546,1568
YKL215C,43,36,15,1784,1827
YKL215C,16,36,16,1934,1950
YKL215C,35,36,17,1974,2009
YKL215C,16,36,18,2028,2044
YKL215C,55,36,19,2033,2088
YKL215C,15,36,20,2197,2212
YKL215C,52,36,21,2203,2255
YKL215C,26,36,22,2262,2288
YKL215C,25,36,23,2465,2490
YKL215C,18,36,24,2493,2511
YKL215C,84,36,25,2563,2647
YKL215C,25,36,26,2687,2712
YKL215C,29,36,27,2705,2734
YKL215C,42,36,28,3134,3176
YKL215C,21,36,29,3219,3240
YKL215C,44,36,30,3254,3298
YKL215C,26,36,31,3303,3329
YKL215C,32,36,32,3344,3376
YKL215C,29,36,33,3413,3442
YKL215C,28,36,34,3445,3473
YKL215C,20,36,35,3475,3495
YKL215C,91,36,36,3696,3787
YDR418W,41,2,1,322,363
YDR418W,21,2,2,407,428
YPL217C,26,8,1,394,420
YPL217C,33,8,2,455,488
YPL217C,29,8,3,1827,1856
YPL217C,43,8,4,2612,2655
YPL217C,23,8,5,3154,3177
YPL217C,33,8,6,3191,3224
YPL217C,18,8,7,3402,3420
YPL217C,49,8,8,3464,3513
YHR114W,16,3,1,281,297
YHR114W,23,3,2,753,776
YHR114W,34,3,3,1858,1892
YBL024W,60,6,1,608,668
YBL024W,16,6,2,863,879
YBL024W,26,6,3,1009,1035
YBL024W,23,6,4,1343,1366
YBL024W,20,6,5,1705,1725
YBL024W,21,6,6,2015,2036
YPR189W,24,15,1,766,790
YPR189W,15,15,2,1187,1202
YPR189W,35,15,3,1190,1225
YPR189W,25,15,4,1228,1253
YPR189W,36,15,5,1443,1479
YPR189W,49,15,6,1616,1665
YPR189W,15,15,7,1863,1878
YPR189W,16,15,8,1886,1902
YPR189W,52,15,9,1943,1995
YPR189W,17,15,10,2268,2285
YPR189W,24,15,11,2383,2407
YPR189W,24,15,12,2408,2432
YPR189W,30,15,13,2678,2708
YPR189W,24,15,14,2884,2908
YPR189W,29,15,15,2948,2977
YDL075W,98,1,1,241,339
YDR127W,31,29,1,800,831
YDR127W,15,29,2,1154,1169
YDR127W,43,29,3,1454,1497
YDR127W,47,29,4,1864,1911
YDR127W,17,29,5,2345,2362
YDR127W,27,29,6,2457,2484
YDR127W,27,29,7,2507,2534
YDR127W,34,29,8,2561,2595
YDR127W,17,29,9,2599,2616
YDR127W,72,29,10,2663,2735
YDR127W,35,29,11,2776,2811
YDR127W,18,29,12,2860,2878
YDR127W,48,29,13,2924,2972
YDR127W,18,29,14,3323,3341
YDR127W,27,29,15,3425,3452
YDR127W,29,29,16,3467,3496
YDR127W,37,29,17,3500,3537
YDR127W,32,29,18,3840,3872
YDR127W,15,29,19,3912,3927
YDR127W,22,29,20,4183,4205
YDR127W,17,29,21,4255,4272
YDR127W,15,29,22,4442,4457
YDR127W,21,29,23,4460,4481
YDR127W,39,29,24,4502,4541
YDR127W,16,29,25,4543,4559
YDR127W,28,29,26,4585,4613
YDR127W,29,29,27,4619,4648
YDR127W,17,29,28,4672,4689
YDR127W,17,29,29,4699,4716
YCL034W,16,1,1,254,270
YOL018C,18,7,1,426,444
YOL018C,19,7,2,446,465
YOL018C,27,7,3,903,930
YOL018C,26,7,4,1066,1092
YOL018C,27,7,5,1094,1121
YOL018C,50,7,6,1110,1160
YOL018C,35,7,7,1147,1182
YBR288C,19,9,1,614,633
YBR288C,40,9,2,640,680
YBR288C,54,9,3,711,765
YBR288C,20,9,4,823,843
YBR288C,34,9,5,866,900
YBR288C,33,9,6,897,930
YBR288C,16,9,7,936,952
YBR288C,32,9,8,1260,1292
YBR288C,20,9,9,1298,1318
YOR259C,29,4,1,536,565
YOR259C,22,4,2,789,811
YOR259C,20,4,3,816,836
YOR259C,51,4,4,827,878
YNL264C,105,11,1,271,376
YNL264C,18,11,2,423,441
YNL264C,25,11,3,491,516
YNL264C,29,11,4,548,577
YNL264C,21,11,5,581,602
YNL264C,43,11,6,603,646
YNL264C,96,11,7,654,750
YNL264C,47,11,8,754,801
YNL264C,21,11,9,812,833
YNL264C,172,11,10,835,1007
YNL264C,37,11,11,1013,1050
YGR117C,49,8,1,431,480
YGR117C,33,8,2,471,504
YGR117C,27,8,3,600,627
YGR117C,18,8,4,629,647
YGR117C,42,8,5,667,709
YGR117C,36,8,6,699,735
YGR117C,62,8,7,899,961
YGR117C,23,8,8,1271,1294
YPR158W,58,2,1,262,320
YPR158W,53,2,2,354,407
YOR142W,22,3,1,611,633
YOR142W,18,3,2,686,704
YOR142W,47,3,3,891,938
YLL024C,33,12,1,219,252
YLL024C,66,12,2,260,326
YLL024C,88,12,3,335,423
YLL024C,43,12,4,432,475
YLL024C,104,12,5,515,619
YLL024C,23,12,6,684,707
YLL024C,172,12,7,749,921
YLL024C,45,12,8,975,1020
YLL024C,45,12,9,1023,1068
YLL024C,117,12,10,1130,1247
YLL024C,72,12,11,1308,1380
YLL024C,33,12,12,1455,1488
YOL027C,15,9,1,272,287
YOL027C,22,9,2,322,344
YOL027C,22,9,3,347,369
YOL027C,69,9,4,370,439
YOL027C,41,9,5,544,585
YOL027C,17,9,6,918,935
YOL027C,31,9,7,992,1023
YOL027C,15,9,8,1241,1256
YOL027C,43,9,9,1507,1550
YOR211C,73,8,1,120,193
YOR211C,69,8,2,196,265
YOR211C,25,8,3,267,292
YOR211C,56,8,4,298,354
YOR211C,15,8,5,355,370
YOR211C,28,8,6,383,411
YOR211C,17,8,7,2171,2188
YOR211C,15,8,8,2192,2207
YCR002C,45,4,1,389,434
YCR002C,19,4,2,474,493
YCR002C,32,4,3,497,529
YCR002C,41,4,4,801,842
YDR033W,27,1,1,211,238
YIL075C,16,5,1,1601,1617
YIL075C,36,5,2,1854,1890
YIL075C,42,5,3,2337,2379
YIL075C,61,5,4,2559,2620
YIL075C,40,5,5,2714,2754
YOL145C,19,4,1,732,751
YOL145C,32,4,2,1587,1619
YOL145C,42,4,3,2166,2208
YOL145C,23,4,4,2210,2233
YIL019W,15,2,1,758,773
YIL019W,22,2,2,840,862
YJL099W,47,4,1,436,483
YJL099W,31,4,2,554,585
YJL099W,21,4,3,2040,2061
YJL099W,16,4,4,2101,2117
YDR395W,32,11,1,318,350
YDR395W,69,11,2,420,489
YDR395W,52,11,3,799,851
YDR395W,16,11,4,948,964
YDR395W,35,11,5,957,992
YDR395W,20,11,6,1033,1053
YDR395W,29,11,7,1597,1626
YDR395W,37,11,8,2023,2060
YDR395W,29,11,9,2189,2218
YDR395W,53,11,10,2271,2324
YDR395W,31,11,11,2699,2730
YNR074C,32,5,1,235,267
YNR074C,16,5,2,746,762
YNR074C,21,5,3,934,955
YNR074C,30,5,4,963,993
YNR074C,16,5,5,1022,1038
YDR005C,27,3,1,580,607
YDR005C,32,3,2,747,779
YDR005C,36,3,3,1032,1068
YPR154W,28,2,1,383,411
YPR154W,16,2,2,445,461
YHL025W,44,1,1,372,416
YOL045W,27,16,1,209,236
YOL045W,36,16,2,251,287
YOL045W,24,16,3,291,315
YOL045W,62,16,4,327,389
YOL045W,31,16,5,443,474
YOL045W,17,16,6,1659,1676
YOL045W,27,16,7,1682,1709
YOL045W,17,16,8,2045,2062
YOL045W,19,16,9,2100,2119
YOL045W,15,16,10,2240,2255
YOL045W,15,16,11,2269,2284
YOL045W,24,16,12,2357,2381
YOL045W,18,16,13,2627,2645
YOL045W,15,16,14,2767,2782
YOL045W,25,16,15,3100,3125
YOL045W,31,16,16,3224,3255
YFR010W,18,6,1,314,332
YFR010W,41,6,2,654,695
YFR010W,20,6,3,784,804
YFR010W,37,6,4,839,876
YFR010W,92,6,5,1063,1155
YFR010W,26,6,6,1209,1235
YHL021C,17,9,1,201,218
YHL021C,51,9,2,572,623
YHL021C,30,9,3,629,659
YHL021C,32,9,4,661,693
YHL021C,16,9,5,757,773
YHL021C,30,9,6,764,794
YHL021C,16,9,7,1048,1064
YHL021C,21,9,8,1086,1107
YHL021C,23,9,9,1266,1289
YJL109C,38,16,1,478,516
YJL109C,31,16,2,672,703
YJL109C,36,16,3,1246,1282
YJL109C,31,16,4,1686,1717
YJL109C,29,16,5,1735,1764
YJL109C,32,16,6,1850,1882
YJL109C,25,16,7,2784,2809
YJL109C,27,16,8,2859,2886
YJL109C,15,16,9,3006,3021
YJL109C,39,16,10,3075,3114
YJL109C,30,16,11,3209,3239
YJL109C,25,16,12,3872,3897
YJL109C,23,16,13,3908,3931
YJL109C,15,16,14,4249,4264
YJL109C,33,16,15,4546,4579
YJL109C,20,16,16,5137,5157
YHR205W,36,18,1,294,330
YHR205W,16,18,2,486,502
YHR205W,36,18,3,734,770
YHR205W,17,18,4,938,955
YHR205W,15,18,5,1006,1021
YHR205W,68,18,6,1033,1101
YHR205W,174,18,7,1111,1285
YHR205W,19,18,8,1287,1306
YHR205W,41,18,9,1323,1364
YHR205W,36,18,10,1569,1605
YHR205W,22,18,11,1621,1643
YHR205W,58,18,12,1669,1727
YHR205W,38,18,13,1728,1766
YHR205W,15,18,14,2006,2021
YHR205W,29,18,15,2023,2052
YHR205W,22,18,16,2096,2118
YHR205W,18,18,17,2140,2158
YHR205W,38,18,18,2152,2190
YAL035W,23,10,1,312,335
YAL035W,21,10,2,1386,1407
YAL035W,24,10,3,1498,1522
YAL035W,79,10,4,1668,1747
YAL035W,40,10,5,2134,2174
YAL035W,39,10,6,2177,2216
YAL035W,38,10,7,2218,2256
YAL035W,18,10,8,2552,2570
YAL035W,41,10,9,2719,2760
YAL035W,30,10,10,2777,2807
YOL121C,31,1,1,404,435
YBL039C,51,10,1,426,477
YBL039C,45,10,2,480,525
YBL039C,61,10,3,756,817
YBL039C,23,10,4,947,970
YBL039C,66,10,5,1117,1183
YBL039C,46,10,6,1200,1246
YBL039C,17,10,7,1338,1355
YBL039C,36,10,8,1523,1559
YBL039C,25,10,9,1611,1636
YBL039C,19,10,10,1694,1713
YER143W,81,4,1,764,845
YER143W,35,4,2,846,881
YER143W,42,4,3,917,959
YER143W,33,4,4,1012,1045
YER089C,15,3,1,456,471
YER089C,55,3,2,1153,1208
YER089C,48,3,3,1207,1255
YPL012W,15,9,1,695,710
YPL012W,29,9,2,1101,1130
YPL012W,29,9,3,1120,1149
YPL012W,79,9,4,1751,1830
YPL012W,32,9,5,2850,2882
YPL012W,44,9,6,3095,3139
YPL012W,43,9,7,3193,3236
YPL012W,26,9,8,3514,3540
YPL012W,22,9,9,3662,3684
YGR284C,92,1,1,316,408
YDL053C,22,3,1,342,364
YDL053C,30,3,2,366,396
YDL053C,30,3,3,514,544
YMR240C,27,4,1,437,464
YMR240C,21,4,2,551,572
YMR240C,30,4,3,748,778
YMR240C,30,4,4,786,816
YML074C,21,2,1,168,189
YML074C,28,2,2,203,231
YCR031C,36,3,1,195,231
YCR031C,23,3,2,240,263
YCR031C,66,3,3,348,414
YPR069C,42,2,1,800,842
YPR069C,38,2,2,844,882
YMR215W,54,3,1,213,267
YMR215W,33,3,2,287,320
YMR215W,34,3,3,401,435
YDR051C,19,1,1,981,1000
YER010C,36,1,1,592,628
YBR078W,39,3,1,496,535
YBR078W,27,3,2,611,638
YBR078W,66,3,3,1215,1281
YBR030W,24,2,1,725,749
YBR030W,29,2,2,740,769
YLR336C,46,6,1,1074,1120
YLR336C,31,6,2,1509,1540
YLR336C,16,6,3,1546,1562
YLR336C,21,6,4,1767,1788
YLR336C,26,6,5,2197,2223
YLR336C,47,6,6,2261,2308
YPL240C,53,9,1,530,583
YPL240C,18,9,2,637,655
YPL240C,39,9,3,682,721
YPL240C,160,9,4,1064,1224
YPL240C,21,9,5,1227,1248
YPL240C,43,9,6,1493,1536
YPL240C,46,9,7,1575,1621
YPL240C,39,9,8,1645,1684
YPL240C,16,9,9,1758,1774
YDL022W,50,6,1,240,290
YDL022W,23,6,2,299,322
YDL022W,15,6,3,435,450
YDL022W,36,6,4,442,478
YDL022W,27,6,5,566,593
YDL022W,24,6,6,1145,1169
YLR044C,33,5,1,426,459
YLR044C,23,5,2,599,622
YLR044C,58,5,3,786,844
YLR044C,41,5,4,1431,1472
YLR044C,65,5,5,1493,1558
YGR244C,15,8,1,417,432
YGR244C,15,8,2,530,545
YGR244C,33,8,3,676,709
YGR244C,19,8,4,913,932
YGR244C,17,8,5,1011,1028
YGR244C,20,8,6,1029,1049
YGR244C,47,8,7,1064,1111
YGR244C,17,8,8,1128,1145
YOR286W,48,3,1,299,347
YOR286W,25,3,2,349,374
YOR286W,41,3,3,392,433
YDR496C,35,1,1,1837,1872
YLR099C,20,2,1,497,517
YLR099C,36,2,2,1116,1152
YML126C,43,13,1,294,337
YML126C,32,13,2,324,356
YML126C,40,13,3,440,480
YML126C,74,13,4,524,598
YML126C,28,13,5,691,719
YML126C,46,13,6,792,838
YML126C,19,13,7,971,990
YML126C,105,13,8,1027,1132
YML126C,16,13,9,1143,1159
YML126C,63,13,10,1161,1224
YML126C,35,13,11,1225,1260
YML126C,17,13,12,1265,1282
YML126C,23,13,13,1355,1378
YOR298C-A,27,1,1,405,432
YML032C,16,5,1,419,435
YML032C,30,5,2,432,462
YML032C,23,5,3,1084,1107
YML032C,29,5,4,1275,1304
YML032C,19,5,5,1371,1390
YDR429C,25,2,1,390,415
YDR429C,140,2,2,682,822
YMR199W,76,5,1,410,486
YMR199W,29,5,2,809,838
YMR199W,26,5,3,1091,1117
YMR199W,16,5,4,1122,1138
YMR199W,19,5,5,1225,1244
YML010W,21,5,1,1040,1061
YML010W,18,5,2,1297,1315
YML010W,52,5,3,1372,1424
YML010W,23,5,4,2563,2586
YML010W,16,5,5,2587,2603
YER074W,192,2,1,134,326
YER074W,65,2,2,331,396
YER021W,28,7,1,544,572
YER021W,26,7,2,631,657
YER021W,32,7,3,679,711
YER021W,87,7,4,1143,1230
YER021W,15,7,5,1231,1246
YER021W,70,7,6,1250,1320
YER021W,47,7,7,1337,1384
YMR208W,58,6,1,485,543
YMR208W,30,6,2,545,575
YMR208W,42,6,3,886,928
YMR208W,32,6,4,916,948
YMR208W,21,6,5,1004,1025
YMR208W,31,6,6,1012,1043
YER134C,56,2,1,297,353
YER134C,34,2,2,341,375
YNL088W,19,24,1,295,314
YNL088W,107,24,2,342,449
YNL088W,18,24,3,544,562
YNL088W,38,24,4,633,671
YNL088W,39,24,5,658,697
YNL088W,58,24,6,715,773
YNL088W,123,24,7,775,898
YNL088W,17,24,8,899,916
YNL088W,32,24,9,1148,1180
YNL088W,35,24,10,1235,1270
YNL088W,29,24,11,1265,1294
YNL088W,27,24,12,1495,1522
YNL088W,44,24,13,1529,1573
YNL088W,32,24,14,1582,1614
YNL088W,34,24,15,2395,2429
YNL088W,16,24,16,2463,2479
YNL088W,61,24,17,2890,2951
YNL088W,18,24,18,3090,3108
YNL088W,50,24,19,3207,3257
YNL088W,20,24,20,3630,3650
YNL088W,34,24,21,4087,4121
YNL088W,77,24,22,4122,4199
YNL088W,30,24,23,4207,4237
YNL088W,25,24,24,4258,4283
YEL009C,16,4,1,572,588
YEL009C,27,4,2,749,776
YEL009C,16,4,3,791,807
YEL009C,20,4,4,816,836
YER161C,38,3,1,143,181
YER161C,21,3,2,273,294
YER161C,24,3,3,408,432
YBR083W,33,5,1,597,630
YBR083W,18,5,2,640,658
YBR083W,15,5,3,1099,1114
YBR083W,15,5,4,1115,1130
YBR083W,22,5,5,1399,1421
YHR103W,17,3,1,1643,1660
YHR103W,21,3,2,1855,1876
YHR103W,29,3,3,2228,2257
YOR001W,17,6,1,638,655
YOR001W,27,6,2,656,683
YOR001W,61,6,3,1183,1244
YOR001W,20,6,4,1908,1928
YOR001W,19,6,5,2054,2073
YOR001W,28,6,6,2092,2120
YDR498C,25,2,1,682,707
YDR498C,21,2,2,1011,1032
YGR002C,48,7,1,385,433
YGR002C,24,7,2,443,467
YGR002C,25,7,3,533,558
YGR002C,18,7,4,766,784
YGR002C,21,7,5,1016,1037
YGR002C,29,7,6,1089,1118
YGR002C,41,7,7,1168,1209
YCR073W-A,18,2,1,506,524
YCR073W-A,32,2,2,867,899
YDR111C,28,4,1,251,279
YDR111C,19,4,2,281,300
YDR111C,32,4,3,698,730
YDR111C,15,4,4,884,899
YGR253C,23,3,1,299,322
YGR253C,28,3,2,536,564
YGR253C,39,3,3,721,760
YKR082W,17,13,1,482,499
YKR082W,45,13,2,507,552
YKR082W,23,13,3,944,967
YKR082W,27,13,4,1131,1158
YKR082W,29,13,5,1186,1215
YKR082W,75,13,6,1287,1362
YKR082W,28,13,7,1369,1397
YKR082W,25,13,8,1611,1636
YKR082W,25,13,9,1912,1937
YKR082W,49,13,10,2045,2094
YKR082W,22,13,11,2423,2445
YKR082W,16,13,12,2717,2733
YKR082W,17,13,13,2762,2779
YOL115W,15,2,1,942,957
YOL115W,33,2,2,967,1000
YPR045C,53,6,1,706,759
YPR045C,29,6,2,760,789
YPR045C,19,6,3,809,828
YPR045C,41,6,4,906,947
YPR045C,22,6,5,1034,1056
YPR045C,15,6,6,1120,1135
YLR419W,21,12,1,925,946
YLR419W,38,12,2,1110,1148
YLR419W,40,12,3,1515,1555
YLR419W,25,12,4,1560,1585
YLR419W,18,12,5,1880,1898
YLR419W,21,12,6,2164,2185
YLR419W,26,12,7,2267,2293
YLR419W,18,12,8,2419,2437
YLR419W,18,12,9,2611,2629
YLR419W,18,12,10,3198,3216
YLR419W,18,12,11,3869,3887
YLR419W,31,12,12,3888,3919
YPR010C,80,23,1,250,330
YPR010C,62,23,2,832,894
YPR010C,60,23,3,903,963
YPR010C,60,23,4,1644,1704
YPR010C,79,23,5,1763,1842
YPR010C,55,23,6,2072,2127
YPR010C,47,23,7,2146,2193
YPR010C,21,23,8,2284,2305
YPR010C,191,23,9,2318,2509
YPR010C,23,23,10,2512,2535
YPR010C,18,23,11,2633,2651
YPR010C,57,23,12,2711,2768
YPR010C,30,23,13,2784,2814
YPR010C,27,23,14,2836,2863
YPR010C,62,23,15,2897,2959
YPR010C,21,23,16,2965,2986
YPR010C,28,23,17,3065,3093
YPR010C,35,23,18,3140,3175
YPR010C,141,23,19,3188,3329
YPR010C,22,23,20,3348,3370
YPR010C,27,23,21,3471,3498
YPR010C,42,23,22,3486,3528
YPR010C,16,23,23,3535,3551
YPL231W,30,16,1,233,263
YPL231W,30,16,2,633,663
YPL231W,22,16,3,831,853
YPL231W,24,16,4,878,902
YPL231W,59,16,5,2258,2317
YPL231W,27,16,6,3059,3086
YPL231W,25,16,7,3110,3135
YPL231W,20,16,8,3138,3158
YPL231W,66,16,9,3305,3371
YPL231W,17,16,10,3396,3413
YPL231W,67,16,11,3619,3686
YPL231W,18,16,12,4104,4122
YPL231W,15,16,13,4381,4396
YPL231W,36,16,14,4397,4433
YPL231W,15,16,15,4677,4692
YPL231W,21,16,16,5051,5072
YDL082W,56,6,1,173,229
YDL082W,23,6,2,249,272
YDL082W,67,6,3,319,386
YDL082W,36,6,4,397,433
YDL082W,16,6,5,437,453
YDL082W,34,6,6,471,505
YJR069C,32,2,1,491,523
YJR069C,22,2,2,572,594
YKR055W,27,5,1,252,279
YKR055W,24,5,2,286,310
YKR055W,25,5,3,379,404
YKR055W,16,5,4,465,481
YKR055W,27,5,5,578,605
YDR351W,43,21,1,463,506
YDR351W,19,21,2,826,845
YDR351W,53,21,3,987,1040
YDR351W,43,21,4,1042,1085
YDR351W,24,21,5,1163,1187
YDR351W,27,21,6,1258,1285
YDR351W,22,21,7,1414,1436
YDR351W,23,21,8,1446,1469
YDR351W,16,21,9,1479,1495
YDR351W,17,21,10,1512,1529
YDR351W,18,21,11,1577,1595
YDR351W,22,21,12,1635,1657
YDR351W,33,21,13,1708,1741
YDR351W,31,21,14,1801,1832
YDR351W,50,21,15,1821,1871
YDR351W,24,21,16,1897,1921
YDR351W,29,21,17,2012,2041
YDR351W,44,21,18,2165,2209
YDR351W,17,21,19,2257,2274
YDR351W,18,21,20,2462,2480
YDR351W,17,21,21,2502,2519
YDR148C,15,5,1,332,347
YDR148C,16,5,2,703,719
YDR148C,29,5,3,724,753
YDR148C,48,5,4,1026,1074
YDR148C,30,5,5,1160,1190
YPL181W,43,2,1,139,182
YPL181W,31,2,2,169,200
YJR034W,26,1,1,300,326
YLR210W,17,3,1,780,797
YLR210W,16,3,2,798,814
YLR210W,38,3,3,866,904
YBR245C,22,5,1,724,746
YBR245C,19,5,2,757,776
YBR245C,26,5,3,1818,1844
YBR245C,20,5,4,2119,2139
YBR245C,18,5,5,2872,2890
YNL026W,32,2,1,434,466
YNL026W,19,2,2,895,914
YDR335W,31,18,1,382,413
YDR335W,49,18,2,448,497
YDR335W,54,18,3,710,764
YDR335W,50,18,4,758,808
YDR335W,15,18,5,938,953
YDR335W,48,18,6,992,1040
YDR335W,16,18,7,1225,1241
YDR335W,37,18,8,1278,1315
YDR335W,16,18,9,1510,1526
YDR335W,25,18,10,1674,1699
YDR335W,28,18,11,1702,1730
YDR335W,16,18,12,1827,1843
YDR335W,30,18,13,2048,2078
YDR335W,24,18,14,2323,2347
YDR335W,35,18,15,2380,2415
YDR335W,21,18,16,2875,2896
YDR335W,19,18,17,2932,2951
YDR335W,21,18,18,2993,3014
YHR081W,80,5,1,133,213
YHR081W,35,5,2,229,264
YHR081W,26,5,3,299,325
YHR081W,20,5,4,332,352
YHR081W,63,5,5,354,417
YER105C,22,24,1,374,396
YER105C,44,24,2,731,775
YER105C,21,24,3,985,1006
YER105C,39,24,4,1023,1062
YER105C,40,24,5,1416,1456
YER105C,42,24,6,1462,1504
YER105C,34,24,7,1529,1563
YER105C,15,24,8,1646,1661
YER105C,27,24,9,1839,1866
YER105C,29,24,10,1879,1908
YER105C,18,24,11,1977,1995
YER105C,58,24,12,2127,2185
YER105C,29,24,13,2301,2330
YER105C,15,24,14,2838,2853
YER105C,30,24,15,2926,2956
YER105C,20,24,16,2984,3004
YER105C,36,24,17,3018,3054
YER105C,28,24,18,3342,3370
YER105C,20,24,19,3402,3422
YER105C,18,24,20,3699,3717
YER105C,41,24,21,3915,3956
YER105C,22,24,22,4014,4036
YER105C,39,24,23,4060,4099
YER105C,20,24,24,4120,4140
YMR039C,28,2,1,283,311
YMR039C,73,2,2,473,546
YDL066W,27,6,1,194,221
YDL066W,53,6,2,423,476
YDL066W,32,6,3,551,583
YDL066W,26,6,4,600,626
YDL066W,28,6,5,697,725
YDL066W,36,6,6,1229,1265
YDL179W,41,3,1,276,317
YDL179W,46,3,2,514,560
YDL179W,25,3,3,875,900
YDR211W,58,14,1,253,311
YDR211W,21,14,2,1137,1158
YDR211W,141,14,3,1159,1300
YDR211W,19,14,4,1313,1332
YDR211W,25,14,5,1333,1358
YDR211W,40,14,6,1349,1389
YDR211W,23,14,7,1393,1416
YDR211W,26,14,8,1458,1484
YDR211W,23,14,9,1579,1602
YDR211W,26,14,10,1621,1647
YDR211W,39,14,11,1730,1769
YDR211W,27,14,12,1885,1912
YDR211W,55,14,13,1954,2009
YDR211W,55,14,14,2048,2103
YMR128W,35,17,1,783,818
YMR128W,30,17,2,821,851
YMR128W,23,17,3,866,889
YMR128W,27,17,4,1490,1517
YMR128W,73,17,5,1708,1781
YMR128W,32,17,6,1796,1828
YMR128W,22,17,7,1907,1929
YMR128W,18,17,8,1964,1982
YMR128W,41,17,9,2045,2086
YMR128W,25,17,10,2470,2495
YMR128W,17,17,11,2550,2567
YMR128W,30,17,12,2635,2665
YMR128W,84,17,13,2864,2948
YMR128W,87,17,14,3069,3156
YMR128W,18,17,15,3247,3265
YMR128W,68,17,16,3291,3359
YMR128W,36,17,17,3764,3800
YLL011W,400,12,1,275,675
YLL011W,39,12,2,674,713
YLL011W,47,12,3,747,794
YLL011W,98,12,4,827,925
YLL011W,24,12,5,963,987
YLL011W,19,12,6,989,1008
YLL011W,36,12,7,1008,1044
YLL011W,19,12,8,1087,1106
YLL011W,69,12,9,1111,1180
YLL011W,134,12,10,1176,1310
YLL011W,26,12,11,1312,1338
YLL011W,19,12,12,1420,1439
YCR077C,34,4,1,1204,1238
YCR077C,46,4,2,1239,1285
YCR077C,34,4,3,1686,1720
YCR077C,46,4,4,1874,1920
YJL029C,26,3,1,662,688
YJL029C,16,3,2,879,895
YJL029C,26,3,3,1654,1680
YGL130W,16,7,1,209,225
YGL130W,15,7,2,264,279
YGL130W,98,7,3,674,772
YGL130W,30,7,4,773,803
YGL130W,28,7,5,988,1016
YGL130W,24,7,6,1023,1047
YGL130W,17,7,7,1304,1321
YMR157C,15,1,1,602,617
YLR437C,15,1,1,204,219
YNL306W,33,9,1,182,215
YNL306W,53,9,2,216,269
YNL306W,16,9,3,270,286
YNL306W,17,9,4,287,304
YNL306W,61,9,5,310,371
YNL306W,49,9,6,372,421
YNL306W,18,9,7,425,443
YNL306W,25,9,8,474,499
YNL306W,24,9,9,500,524
YNL191W,30,3,1,240,270
YNL191W,72,3,2,339,411
YNL191W,21,3,3,557,578
YDR237W,16,6,1,232,248
YDR237W,41,6,2,255,296
YDR237W,20,6,3,374,394
YDR237W,46,6,4,643,689
YDR237W,22,6,5,691,713
YDR237W,35,6,6,792,827
YOR297C,61,4,1,218,279
YOR297C,22,4,2,317,339
YOR297C,41,4,3,352,393
YOR297C,27,4,4,545,572
YDR060W,26,11,1,769,795
YDR060W,49,11,2,993,1042
YDR060W,37,11,3,1054,1091
YDR060W,57,11,4,1288,1345
YDR060W,17,11,5,1593,1610
YDR060W,23,11,6,1625,1648
YDR060W,94,11,7,1937,2031
YDR060W,33,11,8,2174,2207
YDR060W,31,11,9,2595,2626
YDR060W,25,11,10,2683,2708
YDR060W,16,11,11,2811,2827
YBL072C,31,1,1,298,329
YMR080C,84,11,1,564,648
YMR080C,19,11,2,1500,1519
YMR080C,46,11,3,1526,1572
YMR080C,24,11,4,1586,1610
YMR080C,35,11,5,1686,1721
YMR080C,24,11,6,1776,1800
YMR080C,25,11,7,1803,1828
YMR080C,30,11,8,2014,2044
YMR080C,15,11,9,2077,2092
YMR080C,31,11,10,2459,2490
YMR080C,64,11,11,2652,2716
YPR144C,24,4,1,339,363
YPR144C,22,4,2,1321,1343
YPR144C,33,4,3,1350,1383
YPR144C,16,4,4,1581,1597
YKR013W,18,1,1,197,215
YBR001C,26,9,1,367,393
YBR001C,17,9,2,458,475
YBR001C,35,9,3,1060,1095
YBR001C,16,9,4,1267,1283
YBR001C,21,9,5,1353,1374
YBR001C,19,9,6,1689,1708
YBR001C,24,9,7,1914,1938
YBR001C,22,9,8,2085,2107
YBR001C,25,9,9,2165,2190
YNL246W,16,4,1,266,282
YNL246W,19,4,2,346,365
YNL246W,20,4,3,439,459
YNL246W,26,4,4,764,790
YGR145W,30,11,1,359,389
YGR145W,40,11,2,456,496
YGR145W,17,11,3,560,577
YGR145W,41,11,4,572,613
YGR145W,32,11,5,610,642
YGR145W,31,11,6,752,783
YGR145W,20,11,7,784,804
YGR145W,58,11,8,798,856
YGR145W,41,11,9,907,948
YGR145W,29,11,10,1478,1507
YGR145W,27,11,11,1663,1690
YHR196W,34,4,1,862,896
YHR196W,33,4,2,909,942
YHR196W,37,4,3,973,1010
YHR196W,38,4,4,1574,1612
YML092C,48,2,1,516,564
YML092C,41,2,2,570,611
YOR167C,17,1,1,182,199
YMR117C,15,2,1,542,557
YMR117C,35,2,2,607,642
YDL124W,17,2,1,284,301
YDL124W,26,2,2,890,916
YDR257C,15,7,1,243,258
YDR257C,118,7,2,270,388
YDR257C,30,7,3,480,510
YDR257C,22,7,4,536,558
YDR257C,31,7,5,650,681
YDR257C,15,7,6,1350,1365
YDR257C,29,7,7,1418,1447
YPR127W,40,1,1,937,977
YGR266W,38,11,1,304,342
YGR266W,20,11,2,736,756
YGR266W,18,11,3,762,780
YGR266W,73,11,4,924,997
YGR266W,24,11,5,1040,1064
YGR266W,41,11,6,1406,1447
YGR266W,55,11,7,1629,1684
YGR266W,26,11,8,1723,1749
YGR266W,39,11,9,1792,1831
YGR266W,21,11,10,1843,1864
YGR266W,34,11,11,1870,1904
YDL148C,23,6,1,787,810
YDL148C,104,6,2,959,1063
YDL148C,48,6,3,1549,1597
YDL148C,20,6,4,1602,1622
YDL148C,29,6,5,2217,2246
YDL148C,16,6,6,2310,2326
YAL012W,30,2,1,668,698
YAL012W,52,2,2,1017,1069
YHR163W,20,2,1,356,376
YHR163W,20,2,2,695,715
YMR288W,24,6,1,321,345
YMR288W,47,6,2,513,560
YMR288W,20,6,3,773,793
YMR288W,18,6,4,794,812
YMR288W,23,6,5,929,952
YMR288W,38,6,6,1015,1053
YPL196W,53,1,1,386,439
YHR100C,64,5,1,168,232
YHR100C,70,5,2,236,306
YHR100C,29,5,3,312,341
YHR100C,31,5,4,434,465
YHR100C,34,5,5,473,507
YKL059C,42,1,1,284,326
YGL092W,37,7,1,1101,1138
YGL092W,16,7,2,1535,1551
YGL092W,30,7,3,1674,1704
YGL092W,24,7,4,2741,2765
YGL092W,17,7,5,2766,2783
YGL092W,15,7,6,3157,3172
YGL092W,22,7,7,3670,3692
YKL006W,30,1,1,194,224
YGR136W,16,1,1,447,463
YNL097C,45,1,1,317,362
YPL135W,129,4,1,172,301
YPL135W,36,4,2,309,345
YPL135W,101,4,3,348,449
YPL135W,15,4,4,453,468
YOR153W,36,14,1,194,230
YOR153W,68,14,2,900,968
YOR153W,32,14,3,984,1016
YOR153W,19,14,4,1271,1290
YOR153W,44,14,5,1336,1380
YOR153W,77,14,6,1387,1464
YOR153W,28,14,7,1585,1613
YOR153W,72,14,8,1615,1687
YOR153W,20,14,9,1969,1989
YOR153W,34,14,10,2006,2040
YOR153W,27,14,11,2781,2808
YOR153W,27,14,12,3310,3337
YOR153W,21,14,13,3353,3374
YOR153W,27,14,14,3716,3743
YGL201C,28,5,1,1043,1071
YGL201C,39,5,2,1077,1116
YGL201C,20,5,3,1207,1227
YGL201C,48,5,4,1268,1316
YGL201C,19,5,5,2446,2465
YBR121C,43,13,1,203,246
YBR121C,112,13,2,348,460
YBR121C,43,13,3,489,532
YBR121C,36,13,4,534,570
YBR121C,26,13,5,606,632
YBR121C,44,13,6,806,850
YBR121C,20,13,7,952,972
YBR121C,31,13,8,984,1015
YBR121C,49,13,9,1016,1065
YBR121C,43,13,10,1191,1234
YBR121C,23,13,11,1328,1351
YBR121C,39,13,12,1613,1652
YBR121C,42,13,13,1962,2004
YLR229C,51,3,1,337,388
YLR229C,16,3,2,389,405
YLR229C,30,3,3,393,423
YNL079C,41,4,1,268,309
YNL079C,56,4,2,368,424
YNL079C,21,4,3,427,448
YNL079C,18,4,4,558,576
YMR062C,32,6,1,373,405
YMR062C,15,6,2,413,428
YMR062C,22,6,3,690,712
YMR062C,16,6,4,878,894
YMR062C,33,6,5,1051,1084
YMR062C,15,6,6,1218,1233
YLR292C,28,1,1,468,496
YHR170W,67,8,1,379,446
YHR170W,68,8,2,433,501
YHR170W,38,8,3,612,650
YHR170W,15,8,4,651,666
YHR170W,43,8,5,761,804
YHR170W,56,8,6,861,917
YHR170W,48,8,7,929,977
YHR170W,44,8,8,1501,1545
YGL135W,53,3,1,288,341
YGL135W,16,3,2,457,473
YGL135W,44,3,3,576,620
YJL125C,39,2,1,817,856
YJL125C,19,2,2,898,917
YLR312W-A,57,2,1,338,395
YLR312W-A,81,2,2,608,689
YBL090W,15,4,1,173,188
YBL090W,24,4,2,272,296
YBL090W,22,4,3,369,391
YBL090W,18,4,4,498,516
YGL120C,31,11,1,434,465
YGL120C,72,11,2,555,627
YGL120C,75,11,3,657,732
YGL120C,70,11,4,929,999
YGL120C,27,11,5,1135,1162
YGL120C,54,11,6,1399,1453
YGL120C,21,11,7,1475,1496
YGL120C,39,11,8,1771,1810
YGL120C,15,11,9,1826,1841
YGL120C,57,11,10,1969,2026
YGL120C,44,11,11,2254,2298
YKL068W,24,10,1,2027,2051
YKL068W,29,10,2,2038,2067
YKL068W,15,10,3,2101,2116
YKL068W,15,10,4,2117,2132
YKL068W,39,10,5,2197,2236
YKL068W,16,10,6,2308,2324
YKL068W,67,10,7,2315,2382
YKL068W,26,10,8,2598,2624
YKL068W,21,10,9,2691,2712
YKL068W,42,10,10,2760,2802
YDL166C,29,3,1,232,261
YDL166C,23,3,2,447,470
YDL166C,24,3,3,540,564
YKL142W,84,1,1,551,635
YPL049C,59,4,1,1072,1131
YPL049C,69,4,2,1134,1203
YPL049C,22,4,3,1253,1275
YPL049C,62,4,4,1297,1359
YNL064C,27,1,1,732,759
YLR045C,20,5,1,277,297
YLR045C,46,5,2,341,387
YLR045C,29,5,3,2518,2547
YLR045C,16,5,4,2604,2620
YLR045C,36,5,5,2626,2662
YER081W,41,3,1,348,389
YER081W,30,3,2,395,425
YER081W,44,3,3,893,937
YPL178W,29,1,1,590,619
YPR041W,55,7,1,266,321
YPR041W,69,7,2,323,392
YPR041W,67,7,3,418,485
YPR041W,28,7,4,497,525
YPR041W,29,7,5,819,848
YPR041W,27,7,6,928,955
YPR041W,85,7,7,1133,1218
YDR373W,22,1,1,391,413
YDR322W,72,5,1,233,305
YDR322W,18,5,2,328,346
YDR322W,29,5,3,667,696
YDR322W,53,5,4,722,775
YDR322W,18,5,5,776,794
YOL111C,30,3,1,215,245
YOL111C,32,3,2,482,514
YOL111C,30,3,3,567,597
YOR098C,43,7,1,586,629
YOR098C,24,7,2,671,695
YOR098C,39,7,3,1378,1417
YOR098C,16,7,4,1793,1809
YOR098C,21,7,5,2270,2291
YOR098C,33,7,6,2292,2325
YOR098C,51,7,7,3151,3202
YGL227W,60,5,1,497,557
YGL227W,24,5,2,1637,1661
YGL227W,17,5,3,2432,2449
YGL227W,18,5,4,2476,2494
YGL227W,32,5,5,2485,2517
YCR030C,22,1,1,241,263
YIL018W,63,3,1,327,390
YIL018W,73,3,2,560,633
YIL018W,57,3,3,678,735
YIL074C,33,8,1,281,314
YIL074C,64,8,2,338,402
YIL074C,30,8,3,391,421
YIL074C,44,8,4,509,553
YIL074C,26,8,5,554,580
YIL074C,40,8,6,716,756
YIL074C,45,8,7,807,852
YIL074C,63,8,8,877,940
YMR312W,56,1,1,635,691
YOL144W,49,8,1,314,363
YOL144W,54,8,2,644,698
YOL144W,23,8,3,700,723
YOL144W,46,8,4,759,805
YOL144W,31,8,5,794,825
YOL144W,16,8,6,967,983
YOL144W,26,8,7,1089,1115
YOL144W,33,8,8,1367,1400
YMR297W,54,1,1,377,431
YIL021W,34,4,1,404,438
YIL021W,20,4,2,602,622
YIL021W,48,4,3,848,896
YIL021W,24,4,4,933,957
YDL190C,62,4,1,726,788
YDL190C,45,4,2,1588,1633
YDL190C,30,4,3,2505,2535
YDL190C,28,4,4,2656,2684
YLR113W,30,2,1,560,590
YLR113W,15,2,2,1066,1081
YER142C,32,2,1,474,506
YER142C,31,2,2,858,889
YML119W,39,4,1,335,374
YML119W,28,4,2,620,648
YML119W,20,4,3,655,675
YML119W,16,4,4,838,854
YGR056W,23,8,1,903,926
YGR056W,32,8,2,966,998
YGR056W,47,8,3,1011,1058
YGR056W,44,8,4,1340,1384
YGR056W,15,8,5,1592,1607
YGR056W,15,8,6,2384,2399
YGR056W,21,8,7,2486,2507
YGR056W,37,8,8,2560,2597
YGR118W,79,1,1,340,419
YCR035C,33,11,1,261,294
YCR035C,27,11,2,295,322
YCR035C,20,11,3,449,469
YCR035C,23,11,4,565,588
YCR035C,25,11,5,686,711
YCR035C,28,11,6,725,753
YCR035C,41,11,7,741,782
YCR035C,34,11,8,838,872
YCR035C,27,11,9,882,909
YCR035C,16,11,10,915,931
YCR035C,21,11,11,960,981
YGL065C,29,5,1,1033,1062
YGL065C,20,5,2,1177,1197
YGL065C,19,5,3,1313,1332
YGL065C,41,5,4,1354,1395
YGL065C,43,5,5,1429,1472
YKR087C,34,3,1,248,282
YKR087C,19,3,2,410,429
YKR087C,30,3,3,976,1006
YOL120C,117,1,1,222,339
YHR099W,60,12,1,806,866
YHR099W,30,12,2,1364,1394
YHR099W,30,12,3,2627,2657
YHR099W,35,12,4,2713,2748
YHR099W,29,12,5,2736,2765
YHR099W,23,12,6,5504,5527
YHR099W,35,12,7,6530,6565
YHR099W,16,12,8,7366,7382
YHR099W,19,12,9,7895,7914
YHR099W,21,12,10,8462,8483
YHR099W,17,12,11,9674,9691
YHR099W,32,12,12,10904,10936
YLR243W,17,1,1,450,467
YLR196W,30,7,1,449,479
YLR196W,63,7,2,705,768
YLR196W,43,7,3,1057,1100
YLR196W,22,7,4,1102,1124
YLR196W,60,7,5,1461,1521
YLR196W,30,7,6,1515,1545
YLR196W,55,7,7,1669,1724
YIL036W,21,1,1,1048,1069
YOL051W,18,3,1,461,479
YOL051W,36,3,2,648,684
YOL051W,45,3,3,2850,2895
YDR476C,27,3,1,234,261
YDR476C,15,3,2,462,477
YDR476C,16,3,3,555,571
YBR252W,17,4,1,179,196
YBR252W,22,4,2,331,353
YBR252W,24,4,3,359,383
YBR252W,53,4,4,391,444
YGR116W,34,10,1,154,188
YGR116W,57,10,2,1898,1955
YGR116W,46,10,3,2097,2143
YGR116W,30,10,4,2281,2311
YGR116W,16,10,5,2461,2477
YGR116W,17,10,6,2478,2495
YGR116W,23,10,7,2696,2719
YGR116W,24,10,8,3952,3976
YGR116W,30,10,9,4012,4042
YGR116W,21,10,10,4154,4175
YIL110W,19,3,1,739,758
YIL110W,33,3,2,937,970
YIL110W,35,3,3,1075,1110
YPL183W-A,51,2,1,201,252
YPL183W-A,22,2,2,253,275
YIL069C,180,2,1,140,320
YIL069C,26,2,2,332,358
YBR169C,41,9,1,254,295
YBR169C,58,9,2,396,454
YBR169C,70,9,3,556,626
YBR169C,15,9,4,906,921
YBR169C,51,9,5,1294,1345
YBR169C,49,9,6,1418,1467
YBR169C,68,9,7,1554,1622
YBR169C,42,9,8,1623,1665
YBR169C,17,9,9,2062,2079
YNL135C,30,1,1,224,254
YJR101W,27,3,1,167,194
YJR101W,24,3,2,203,227
YJR101W,41,3,3,496,537
YGL147C,45,2,1,203,248
YGL147C,27,2,2,249,276
YBR263W,18,8,1,259,277
YBR263W,63,8,2,283,346
YBR263W,72,8,3,421,493
YBR263W,28,8,4,711,739
YBR263W,20,8,5,745,765
YBR263W,47,8,6,980,1027
YBR263W,27,8,7,1108,1135
YBR263W,23,8,8,1427,1450
YBL001C,52,1,1,241,293
YBR185C,27,2,1,428,455
YBR185C,18,2,2,462,480
YDR019C,47,6,1,254,301
YDR019C,66,6,2,363,429
YDR019C,46,6,3,746,792
YDR019C,17,6,4,825,842
YDR019C,17,6,5,1074,1091
YDR019C,29,6,6,1118,1147
YNL207W,24,4,1,321,345
YNL207W,41,4,2,624,665
YNL207W,49,4,3,955,1004
YNL207W,25,4,4,1158,1183
YOR232W,20,3,1,184,204
YOR232W,29,3,2,213,242
YOR232W,22,3,3,614,636
YJL085W,56,1,1,587,643
YEL055C,17,7,1,419,436
YEL055C,32,7,2,785,817
YEL055C,58,7,3,1760,1818
YEL055C,42,7,4,1961,2003
YEL055C,15,7,5,2239,2254
YEL055C,39,7,6,2401,2440
YEL055C,52,7,7,3017,3069
YGR058W,42,1,1,791,833
YBR053C,49,5,1,159,208
YBR053C,40,5,2,239,279
YBR053C,30,5,3,654,684
YBR053C,34,5,4,771,805
YBR053C,49,5,5,968,1017
YLL058W,16,6,1,310,326
YLL058W,18,6,2,347,365
YLL058W,36,6,3,365,401
YLL058W,25,6,4,443,468
YLL058W,30,6,5,1045,1075
YLL058W,48,6,6,1679,1727
YDR428C,61,6,1,210,271
YDR428C,16,6,2,311,327
YDR428C,37,6,3,354,391
YDR428C,17,6,4,408,425
YDR428C,21,6,5,431,452
YDR428C,105,6,6,678,783
YLR029C,48,4,1,204,252
YLR029C,81,4,2,273,354
YLR029C,21,4,3,360,381
YLR029C,25,4,4,470,495
YNL163C,47,17,1,352,399
YNL163C,39,17,2,567,606
YNL163C,22,17,3,871,893
YNL163C,21,17,4,1141,1162
YNL163C,58,17,5,1347,1405
YNL163C,15,17,6,1548,1563
YNL163C,29,17,7,1638,1667
YNL163C,24,17,8,1875,1899
YNL163C,18,17,9,1992,2010
YNL163C,31,17,10,2218,2249
YNL163C,23,17,11,2307,2330
YNL163C,24,17,12,2485,2509
YNL163C,29,17,13,2512,2541
YNL163C,22,17,14,2557,2579
YNL163C,38,17,15,2703,2741
YNL163C,18,17,16,3090,3108
YNL163C,35,17,17,3099,3134
YGL246C,27,5,1,359,386
YGL246C,18,5,2,507,525
YGL246C,41,5,3,562,603
YGL246C,17,5,4,870,887
YGL246C,16,5,5,956,972
YCR054C,64,2,1,778,842
YCR054C,15,2,2,1235,1250
YDR045C,36,2,1,201,237
YDR045C,32,2,2,237,269
YKR083C,25,1,1,377,402
YMR209C,23,1,1,1023,1046
YGR252W,38,3,1,723,761
YGR252W,17,3,2,1024,1041
YGR252W,26,3,3,1032,1058
YDL003W,16,4,1,191,207
YDL003W,22,4,2,326,348
YDL003W,16,4,3,530,546
YDL003W,22,4,4,756,778
YDL235C,22,1,1,395,417
YJR123W,177,3,1,241,418
YJR123W,43,3,2,452,495
YJR123W,40,3,3,619,659
YDL078C,30,1,1,534,564
YGR003W,22,2,1,547,569
YGR003W,26,2,2,2063,2089
YDR517W,15,3,1,198,213
YDR517W,19,3,2,508,527
YDR517W,83,3,3,843,926
YDR110W,18,2,1,557,575
YDR110W,27,2,2,874,901
YOL088C,22,2,1,452,474
YOL088C,18,2,2,659,677
YOR361C,23,9,1,469,492
YOR361C,44,9,2,899,943
YOR361C,29,9,3,932,961
YOR361C,68,9,4,964,1032
YOR361C,39,9,5,1170,1209
YOR361C,30,9,6,1252,1282
YOR361C,44,9,7,1435,1479
YOR361C,81,9,8,1640,1721
YOR361C,20,9,9,2022,2042
YOR221C,20,3,1,588,608
YOR221C,30,3,2,814,844
YOR221C,17,3,3,878,895
YKR095W,18,7,1,317,335
YKR095W,33,7,2,2365,2398
YKR095W,42,7,3,2660,2702
YKR095W,25,7,4,2802,2827
YKR095W,31,7,5,2927,2958
YKR095W,33,7,6,3590,3623
YKR095W,24,7,7,4834,4858
YOL064C,53,2,1,587,640
YOL064C,15,2,2,976,991
YBL023C,33,6,1,1298,1331
YBL023C,30,6,2,1502,1532
YBL023C,35,6,3,2031,2066
YBL023C,25,6,4,2163,2188
YBL023C,30,6,5,2507,2537
YBL023C,27,6,6,2544,2571
YGL078C,17,3,1,461,478
YGL078C,44,3,2,574,618
YGL078C,77,3,3,773,850
YDR435C,35,1,1,279,314
YER151C,61,14,1,743,804
YER151C,22,14,2,1208,1230
YER151C,32,14,3,1491,1523
YER151C,36,14,4,1512,1548
YER151C,38,14,5,1556,1594
YER151C,17,14,6,1645,1662
YER151C,31,14,7,1663,1694
YER151C,47,14,8,1843,1890
YER151C,23,14,9,1907,1930
YER151C,22,14,10,2239,2261
YER151C,18,14,11,2281,2299
YER151C,26,14,12,2494,2520
YER151C,33,14,13,2571,2604
YER151C,45,14,14,2667,2712
YLR005W,26,2,1,952,978
YLR005W,30,2,2,1252,1282
YJL076W,25,14,1,539,564
YJL076W,55,14,2,568,623
YJL076W,23,14,3,728,751
YJL076W,31,14,4,756,787
YJL076W,38,14,5,1070,1108
YJL076W,18,14,6,1190,1208
YJL076W,20,14,7,1222,1242
YJL076W,37,14,8,1728,1765
YJL076W,32,14,9,1782,1814
YJL076W,60,14,10,2078,2138
YJL076W,29,14,11,2413,2442
YJL076W,33,14,12,2465,2498
YJL076W,39,14,13,3023,3062
YJL076W,18,14,14,3328,3346
YOR253W,24,1,1,214,238
YNL267W,22,7,1,323,345
YNL267W,19,7,2,500,519
YNL267W,25,7,3,566,591
YNL267W,18,7,4,2302,2320
YNL267W,17,7,5,2322,2339
YNL267W,24,7,6,2601,2625
YNL267W,30,7,7,3169,3199
YGR198W,38,4,1,224,262
YGR198W,47,4,2,303,350
YGR198W,28,4,3,1402,1430
YGR198W,18,4,4,1724,1742
YKL189W,29,1,1,649,678
YAR007C,27,5,1,750,777
YAR007C,23,5,2,798,821
YAR007C,32,5,3,836,868
YAR007C,25,5,4,947,972
YAR007C,15,5,5,1736,1751
YGR010W,54,8,1,224,278
YGR010W,18,8,2,284,302
YGR010W,54,8,3,306,360
YGR010W,18,8,4,457,475
YGR010W,37,8,5,503,540
YGR010W,20,8,6,761,781
YGR010W,17,8,7,1145,1162
YGR010W,21,8,8,1166,1187
YML064C,34,1,1,466,500
YER055C,47,6,1,183,230
YER055C,58,6,2,417,475
YER055C,91,6,3,482,573
YER055C,42,6,4,759,801
YER055C,17,6,5,817,834
YER055C,17,6,6,865,882
YNL307C,74,8,1,236,310
YNL307C,20,8,2,322,342
YNL307C,34,8,3,348,382
YNL307C,109,8,4,536,645
YNL307C,50,8,5,753,803
YNL307C,22,8,6,857,879
YNL307C,47,8,7,969,1016
YNL307C,17,8,8,1099,1116
YCR016W,30,2,1,704,734
YCR016W,43,2,2,750,793
YCL052C,29,3,1,539,568
YCL052C,16,3,2,1035,1051
YCL052C,16,3,3,1052,1068
YDR067C,29,3,1,349,378
YDR067C,34,3,2,411,445
YDR067C,32,3,3,433,465
YHR167W,44,2,1,327,371
YHR167W,42,2,2,537,579
YJL044C,27,2,1,713,740
YJL044C,18,2,2,904,922
YDR234W,16,16,1,250,266
YDR234W,23,16,2,290,313
YDR234W,31,16,3,319,350
YDR234W,35,16,4,359,394
YDR234W,29,16,5,395,424
YDR234W,22,16,6,440,462
YDR234W,21,16,7,479,500
YDR234W,23,16,8,644,667
YDR234W,15,16,9,668,683
YDR234W,18,16,10,970,988
YDR234W,30,16,11,1014,1044
YDR234W,28,16,12,1046,1074
YDR234W,22,16,13,1383,1405
YDR234W,19,16,14,1459,1478
YDR234W,24,16,15,1769,1793
YDR234W,26,16,16,2032,2058
YGR218W,19,12,1,602,621
YGR218W,56,12,2,857,913
YGR218W,81,12,3,1398,1479
YGR218W,24,12,4,1508,1532
YGR218W,44,12,5,1758,1802
YGR218W,23,12,6,1803,1826
YGR218W,15,12,7,1858,1873
YGR218W,39,12,8,1941,1980
YGR218W,22,12,9,2087,2109
YGR218W,23,12,10,2310,2333
YGR218W,39,12,11,2681,2720
YGR218W,23,12,12,3195,3218
YEL060C,23,3,1,1273,1296
YEL060C,49,3,2,1302,1351
YEL060C,20,3,3,1626,1646
YPR179C,25,3,1,656,681
YPR179C,88,3,2,950,1038
YPR179C,25,3,3,1683,1708
YGR267C,39,4,1,392,431
YGR267C,16,4,2,503,519
YGR267C,46,4,3,530,576
YGR267C,62,4,4,608,670
YDL225W,51,3,1,360,411
YDL225W,17,3,2,412,429
YDL225W,26,3,3,842,868
YML026C,23,1,1,278,301
YPL002C,36,2,1,398,434
YPL002C,31,2,2,425,456
YML079W,17,1,1,557,574
YLR180W,28,5,1,649,677
YLR180W,186,5,2,729,915
YLR180W,22,5,3,916,938
YLR180W,98,5,4,964,1062
YLR180W,24,5,5,1123,1147
YMR049C,59,5,1,824,883
YMR049C,99,5,2,1393,1492
YMR049C,33,5,3,1481,1514
YMR049C,15,5,4,1571,1586
YMR049C,18,5,5,2367,2385
YPR124W,30,1,1,542,572
YLL029W,43,8,1,607,650
YLL029W,36,8,2,671,707
YLL029W,25,8,3,758,783
YLL029W,72,8,4,890,962
YLL029W,15,8,5,1156,1171
YLL029W,38,8,6,1162,1200
YLL029W,18,8,7,1231,1249
YLL029W,34,8,8,1272,1306
YOR344C,34,1,1,184,218
YGR285C,117,2,1,423,540
YGR285C,46,2,2,527,573
YNL232W,79,1,1,764,843
YMR241W,80,2,1,478,558
YMR241W,43,2,2,715,758
YCL063W,25,2,1,340,365
YCL063W,27,2,2,668,695
YLR440C,44,3,1,891,935
YLR440C,28,3,2,1754,1782
YLR440C,42,3,3,1775,1817
YML048W,15,2,1,273,288
YML048W,24,2,2,298,322
YNL112W,32,9,1,731,763
YNL112W,19,9,2,764,783
YNL112W,29,9,3,790,819
YNL112W,16,9,4,865,881
YNL112W,19,9,5,889,908
YNL112W,27,9,6,918,945
YNL112W,45,9,7,989,1034
YNL112W,30,9,8,1046,1076
YNL112W,24,9,9,1408,1432
YLR027C,27,6,1,231,258
YLR027C,31,6,2,476,507
YLR027C,21,6,3,530,551
YLR027C,58,6,4,821,879
YLR027C,74,6,5,935,1009
YLR027C,70,6,6,1130,1200
YBR031W,232,2,1,344,576
YBR031W,61,2,2,1025,1086
YDL132W,66,8,1,449,515
YDL132W,32,8,2,871,903
YDL132W,15,8,3,1765,1780
YDL132W,39,8,4,2000,2039
YDL132W,57,8,5,2212,2269
YDL132W,17,8,6,2285,2302
YDL132W,25,8,7,2391,2416
YDL132W,25,8,8,2423,2448
YBL064C,33,5,1,171,204
YBL064C,21,5,2,244,265
YBL064C,45,5,3,271,316
YBL064C,30,5,4,660,690
YBL064C,21,5,5,693,714
YGR245C,22,4,1,541,563
YGR245C,31,4,2,1388,1419
YGR245C,32,4,3,1488,1520
YGR245C,25,4,4,2197,2222
YPL243W,35,6,1,737,772
YPL243W,32,6,2,802,834
YPL243W,24,6,3,836,860
YPL243W,75,6,4,1387,1462
YPL243W,24,6,5,1551,1575
YPL243W,93,6,6,1687,1780
YGR229C,24,5,1,165,189
YGR229C,23,5,2,506,529
YGR229C,17,5,3,807,824
YGR229C,32,5,4,825,857
YGR229C,62,5,5,1115,1177
YLR167W,19,1,1,427,446
YLR293C,75,2,1,412,487
YLR293C,94,2,2,519,613
YDL147W,43,3,1,895,938
YDL147W,54,3,2,1016,1070
YDL147W,44,3,3,1071,1115
YFL029C,34,3,1,191,225
YFL029C,24,3,2,307,331
YFL029C,40,3,3,764,804
YBL091C,74,3,1,923,997
YBL091C,36,3,2,1004,1040
YBL091C,62,3,3,1131,1193
YOR262W,29,2,1,466,495
YOR262W,24,2,2,674,698
YMR014W,29,4,1,275,304
YMR014W,24,4,2,410,434
YMR014W,42,4,3,452,494
YMR014W,34,4,4,567,601
YDL167C,38,6,1,375,413
YDL167C,50,6,2,415,465
YDL167C,18,6,3,752,770
YDL167C,16,6,4,812,828
YDL167C,18,6,5,897,915
YDL167C,18,6,6,996,1014
YER082C,30,2,1,882,912
YER082C,37,2,2,1148,1185
YIL137C,15,11,1,174,189
YIL137C,40,11,2,581,621
YIL137C,35,11,3,620,655
YIL137C,48,11,4,741,789
YIL137C,33,11,5,1036,1069
YIL137C,53,11,6,1302,1355
YIL137C,35,11,7,1551,1586
YIL137C,16,11,8,1659,1675
YIL137C,38,11,9,2273,2311
YIL137C,29,11,10,2452,2481
YIL137C,27,11,11,2597,2624
YNL123W,55,18,1,619,674
YNL123W,65,18,2,1003,1068
YNL123W,20,18,3,1071,1091
YNL123W,19,18,4,1114,1133
YNL123W,21,18,5,1272,1293
YNL123W,44,18,6,1530,1574
YNL123W,42,18,7,1630,1672
YNL123W,24,18,8,1784,1808
YNL123W,36,18,9,1881,1917
YNL123W,17,18,10,1920,1937
YNL123W,60,18,11,1938,1998
YNL123W,51,18,12,2023,2074
YNL123W,40,18,13,2183,2223
YNL123W,16,18,14,2262,2278
YNL123W,32,18,15,2466,2498
YNL123W,74,18,16,2814,2888
YNL123W,23,18,17,2954,2977
YNL123W,15,18,18,2979,2994
YMR003W,18,1,1,265,283
YKL145W,92,9,1,268,360
YKL145W,86,9,2,412,498
YKL145W,16,9,3,553,569
YKL145W,19,9,4,570,589
YKL145W,33,9,5,598,631
YKL145W,27,9,6,674,701
YKL145W,113,9,7,912,1025
YKL145W,46,9,8,1174,1220
YKL145W,57,9,9,1302,1359
YEL056W,15,4,1,224,239
YEL056W,27,4,2,742,769
YEL056W,42,4,3,887,929
YEL056W,23,4,4,975,998
YLR373C,46,8,1,546,592
YLR373C,16,8,2,598,614
YLR373C,29,8,3,718,747
YLR373C,35,8,4,751,786
YLR373C,16,8,5,1109,1125
YLR373C,43,8,6,1164,1207
YLR373C,19,8,7,1871,1890
YLR373C,23,8,8,2482,2505
YOR111W,20,5,1,313,333
YOR111W,21,5,2,335,356
YOR111W,37,5,3,491,528
YOR111W,82,5,4,515,597
YOR111W,47,5,5,584,631
YFL016C,79,5,1,775,854
YFL016C,26,5,2,855,881
YFL016C,15,5,3,1197,1212
YFL016C,22,5,4,1230,1252
YFL016C,37,5,5,1290,1327
YDR451C,45,5,1,467,512
YDR451C,32,5,2,499,531
YDR451C,27,5,3,531,558
YDR451C,61,5,4,732,793
YDR451C,23,5,5,798,821
YLR260W,31,5,1,820,851
YLR260W,17,5,2,854,871
YLR260W,16,5,3,874,890
YLR260W,62,5,4,1499,1561
YLR260W,18,5,5,1764,1782
YNL032W,34,1,1,649,683
YKR001C,38,3,1,926,964
YKR001C,22,3,2,1164,1186
YKR001C,38,3,3,2050,2088
YMR001C,27,4,1,1482,1509
YMR001C,15,4,2,1671,1686
YMR001C,20,4,3,1879,1899
YMR001C,23,4,4,1932,1955
YJL006C,60,4,1,312,372
YJL006C,33,4,2,552,585
YJL006C,17,4,3,687,704
YJL006C,18,4,4,720,738
YBL082C,42,2,1,186,228
YBL082C,15,2,2,255,270
YIR034C,55,2,1,557,612
YIR034C,17,2,2,666,683
YDR165W,67,4,1,962,1029
YDR165W,37,4,2,1116,1153
YDR165W,19,4,3,1171,1190
YDR165W,46,4,4,1221,1267
YFL018C,89,7,1,513,602
YFL018C,24,7,2,670,694
YFL018C,24,7,3,894,918
YFL018C,20,7,4,936,956
YFL018C,37,7,5,1103,1140
YFL018C,25,7,6,1145,1170
YFL018C,18,7,7,1434,1452
YJR068W,50,4,1,254,304
YJR068W,30,4,2,298,328
YJR068W,25,4,3,518,543
YJR068W,27,4,4,662,689
YDL178W,45,4,1,263,308
YDL178W,22,4,2,487,509
YDL178W,27,4,3,1028,1055
YDL178W,31,4,4,1513,1544
YER095W,23,6,1,725,748
YER095W,16,6,2,771,787
YER095W,19,6,3,810,829
YER095W,21,6,4,833,854
YER095W,29,6,5,1043,1072
YER095W,17,6,6,1151,1168
YLR170C,40,2,1,185,225
YLR170C,33,2,2,303,336
YML086C,22,9,1,252,274
YML086C,24,9,2,678,702
YML086C,22,9,3,705,727
YML086C,129,9,4,799,928
YML086C,37,9,5,950,987
YML086C,48,9,6,1304,1352
YML086C,68,9,7,1360,1428
YML086C,59,9,8,1429,1488
YML086C,55,9,9,1518,1573
YKR030W,66,1,1,346,412
YPL015C,35,2,1,297,332
YPL015C,20,2,2,651,671
YGL213C,26,6,1,580,606
YGL213C,50,6,2,798,848
YGL213C,44,6,3,850,894
YGL213C,16,6,4,895,911
YGL213C,37,6,5,912,949
YGL213C,44,6,6,1067,1111
YDR231C,23,1,1,342,365
YMR038C,96,2,1,428,524
YMR038C,80,2,2,668,748
YNL071W,98,12,1,150,248
YNL071W,27,12,2,260,287
YNL071W,34,12,3,313,347
YNL071W,40,12,4,373,413
YNL071W,41,12,5,434,475
YNL071W,32,12,6,527,559
YNL071W,20,12,7,560,580
YNL071W,50,12,8,993,1043
YNL071W,50,12,9,1050,1100
YNL071W,17,12,10,1101,1118
YNL071W,37,12,11,1253,1290
YNL071W,40,12,12,1277,1317
YNL321W,27,3,1,738,765
YNL321W,26,3,2,809,835
YNL321W,25,3,3,940,965
YNR029C,30,4,1,560,590
YNR029C,31,4,2,926,957
YNR029C,29,4,3,948,977
YNR029C,18,4,4,1029,1047
YBR122C,58,5,1,186,244
YBR122C,87,5,2,256,343
YBR122C,74,5,3,347,421
YBR122C,19,5,4,426,445
YBR122C,33,5,5,501,534
YHR001W,38,5,1,498,536
YHR001W,50,5,2,986,1036
YHR001W,16,5,3,1092,1108
YHR001W,16,5,4,1193,1209
YHR001W,25,5,5,1226,1251
YDR477W,78,4,1,353,431
YDR477W,39,4,2,465,504
YDR477W,34,4,3,866,900
YDR477W,39,4,4,1745,1784
YJL010C,45,2,1,438,483
YJL010C,21,2,2,1859,1880
YOR042W,18,1,1,916,934
YOR342C,18,2,1,245,263
YOR342C,18,2,2,339,357
YJR148W,76,10,1,277,353
YJR148W,28,10,2,407,435
YJR148W,15,10,3,458,473
YJR148W,31,10,4,524,555
YJR148W,19,10,5,556,575
YJR148W,67,10,6,612,679
YJR148W,59,10,7,773,832
YJR148W,37,10,8,902,939
YJR148W,57,10,9,928,985
YJR148W,16,10,10,1106,1122
YIL035C,116,9,1,136,252
YIL035C,39,9,2,306,345
YIL035C,36,9,3,347,383
YIL035C,69,9,4,468,537
YIL035C,38,9,5,540,578
YIL035C,66,9,6,710,776
YIL035C,29,9,7,771,800
YIL035C,53,9,8,827,880
YIL035C,41,9,9,1044,1085
YML121W,23,2,1,393,416
YML121W,36,2,2,501,537
YOL087C,20,8,1,338,358
YOL087C,64,8,2,515,579
YOL087C,16,8,3,745,761
YOL087C,27,8,4,1002,1029
YOL087C,25,8,5,2610,2635
YOL087C,17,8,6,2967,2984
YOL087C,47,8,7,3246,3293
YOL087C,18,8,8,3303,3321
YNL134C,29,1,1,778,807
YNR061C,25,2,1,159,184
YNR061C,23,2,2,185,208
YHR154W,21,8,1,248,269
YHR154W,23,8,2,512,535
YHR154W,33,8,3,1011,1044
YHR154W,41,8,4,1135,1176
YHR154W,16,8,5,1218,1234
YHR154W,15,8,6,1247,1262
YHR154W,16,8,7,1281,1297
YHR154W,17,8,8,1881,1898
YOR008C,30,2,1,708,738
YOR008C,22,2,2,809,831
YMR304W,35,16,1,653,688
YMR304W,31,16,2,723,754
YMR304W,34,16,3,987,1021
YMR304W,31,16,4,1174,1205
YMR304W,48,16,5,1305,1353
YMR304W,28,16,6,1588,1616
YMR304W,30,16,7,1792,1822
YMR304W,17,16,8,1896,1913
YMR304W,42,16,9,2048,2090
YMR304W,16,16,10,2157,2173
YMR304W,20,16,11,2461,2481
YMR304W,16,16,12,2500,2516
YMR304W,22,16,13,2520,2542
YMR304W,22,16,14,2778,2800
YMR304W,17,16,15,3048,3065
YMR304W,21,16,16,3076,3097
YOL130W,20,9,1,751,771
YOL130W,18,9,2,1256,1274
YOL130W,32,9,3,1525,1557
YOL130W,37,9,4,1741,1778
YOL130W,26,9,5,1782,1808
YOL130W,18,9,6,1819,1837
YOL130W,22,9,7,2202,2224
YOL130W,22,9,8,2333,2355
YOL130W,17,9,9,2459,2476
YPL199C,45,3,1,204,249
YPL199C,17,3,2,366,383
YPL199C,18,3,3,491,509
YFL036W,16,4,1,922,938
YFL036W,37,4,2,1483,1520
YFL036W,15,4,3,2171,2186
YFL036W,25,4,4,2633,2658
YGR177C,23,6,1,361,384
YGR177C,23,6,2,391,414
YGR177C,29,6,3,415,444
YGR177C,51,6,4,543,594
YGR177C,15,6,5,1050,1065
YGR177C,40,6,6,1119,1159
YKL045W,58,6,1,277,335
YKL045W,28,6,2,449,477
YKL045W,36,6,3,550,586
YKL045W,20,6,4,823,843
YKL045W,30,6,5,831,861
YKL045W,22,6,6,942,964
YIL157C,17,1,1,446,463
YNL074C,34,14,1,335,369
YNL074C,29,14,2,507,536
YNL074C,21,14,3,633,654
YNL074C,74,14,4,655,729
YNL074C,50,14,5,716,766
YNL074C,34,14,6,803,837
YNL074C,18,14,7,906,924
YNL074C,24,14,8,928,952
YNL074C,20,14,9,1043,1063
YNL074C,41,14,10,1064,1105
YNL074C,16,14,11,1163,1179
YNL074C,22,14,12,1270,1292
YNL074C,17,14,13,1295,1312
YNL074C,17,14,14,1325,1342
YKL007W,29,2,1,376,405
YKL007W,32,2,2,415,447
YNL169C,33,1,1,1246,1279
YFR034C,44,2,1,444,488
YFR034C,28,2,2,747,775
YGL206C,26,27,1,192,218
YGL206C,61,27,2,234,295
YGL206C,44,27,3,297,341
YGL206C,40,27,4,375,415
YGL206C,112,27,5,416,528
YGL206C,45,27,6,675,720
YGL206C,17,27,7,771,788
YGL206C,75,27,8,1044,1119
YGL206C,68,27,9,1124,1192
YGL206C,55,27,10,1461,1516
YGL206C,29,27,11,1638,1667
YGL206C,16,27,12,1743,1759
YGL206C,30,27,13,2067,2097
YGL206C,33,27,14,2126,2159
YGL206C,43,27,15,2237,2280
YGL206C,49,27,16,2300,2349
YGL206C,36,27,17,2784,2820
YGL206C,36,27,18,3254,3290
YGL206C,18,27,19,3921,3939
YGL206C,18,27,20,4117,4135
YGL206C,24,27,21,4361,4385
YGL206C,30,27,22,4378,4408
YGL206C,36,27,23,4437,4473
YGL206C,18,27,24,4478,4496
YGL206C,27,27,25,4744,4771
YGL206C,39,27,26,4884,4923
YGL206C,21,27,27,4940,4961
YGL091C,21,1,1,563,584
YHR070W,49,6,1,316,365
YHR070W,28,6,2,368,396
YHR070W,49,6,3,448,497
YHR070W,24,6,4,562,586
YHR070W,28,6,5,618,646
YHR070W,33,6,6,941,974
YDR460W,32,1,1,897,929
YKL085W,96,3,1,229,325
YKL085W,31,3,2,623,654
YKL085W,37,3,3,641,678
YOR360C,41,5,1,231,272
YOR360C,51,5,2,300,351
YOR360C,28,5,3,842,870
YOR360C,18,5,4,1010,1028
YOR360C,16,5,5,1236,1252
YOR335C,85,13,1,225,310
YOR335C,66,13,2,360,426
YOR335C,39,13,3,525,564
YOR335C,20,13,4,749,769
YOR335C,48,13,5,833,881
YOR335C,229,13,6,953,1182
YOR335C,27,13,7,1185,1212
YOR335C,23,13,8,1254,1277
YOR335C,45,13,9,1299,1344
YOR335C,67,13,10,1802,1869
YOR335C,29,13,11,2199,2228
YOR335C,16,13,12,2249,2265
YOR335C,15,13,13,2393,2408
YMR099C,39,4,1,246,285
YMR099C,29,4,2,297,326
YMR099C,74,4,3,363,437
YMR099C,42,4,4,812,854
YLR193C,85,1,1,322,407
YHR023W,29,18,1,303,332
YHR023W,26,18,2,411,437
YHR023W,33,18,3,470,503
YHR023W,29,18,4,558,587
YHR023W,21,18,5,799,820
YHR023W,19,18,6,1049,1068
YHR023W,20,18,7,1069,1089
YHR023W,44,18,8,1076,1120
YHR023W,43,18,9,1573,1616
YHR023W,22,18,10,1738,1760
YHR023W,18,18,11,1859,1877
YHR023W,15,18,12,1974,1989
YHR023W,29,18,13,2100,2129
YHR023W,16,18,14,4626,4642
YHR023W,17,18,15,4643,4660
YHR023W,16,18,16,5263,5279
YHR023W,28,18,17,5517,5545
YHR023W,26,18,18,5745,5771
YDR097C,19,6,1,1634,1653
YDR097C,45,6,2,1666,1711
YDR097C,36,6,3,1704,1740
YDR097C,22,6,4,2264,2286
YDR097C,33,6,5,2273,2306
YDR097C,35,6,6,3516,3551
YBL022C,39,8,1,195,234
YBL022C,17,8,2,242,259
YBL022C,38,8,3,250,288
YBL022C,101,8,4,289,390
YBL022C,26,8,5,1757,1783
YBL022C,20,8,6,2074,2094
YBL022C,34,8,7,2870,2904
YBL022C,44,8,8,2947,2991
YPL215W,45,3,1,637,682
YPL215W,34,3,2,674,708
YPL215W,26,3,3,927,953
YER156C,41,2,1,272,313
YER156C,16,2,2,366,382
YNL298W,15,11,1,377,392
YNL298W,28,11,2,405,433
YNL298W,31,11,3,1376,1407
YNL298W,36,11,4,1421,1457
YNL298W,18,11,5,1594,1612
YNL298W,21,11,6,1615,1636
YNL298W,42,11,7,1725,1767
YNL298W,32,11,8,1800,1832
YNL298W,26,11,9,1887,1913
YNL298W,52,11,10,1913,1965
YNL298W,21,11,11,2240,2261
YOR095C,31,3,1,342,373
YOR095C,45,3,2,645,690
YOR095C,34,3,3,733,767
YOR377W,30,4,1,321,351
YOR377W,26,4,2,711,737
YOR377W,16,4,3,1140,1156
YOR377W,27,4,4,1186,1213
YLL026W,54,10,1,331,385
YLL026W,33,10,2,706,739
YLL026W,54,10,3,1267,1321
YLL026W,20,10,4,1429,1449
YLL026W,107,10,5,1909,2016
YLL026W,15,10,6,2042,2057
YLL026W,63,10,7,2044,2107
YLL026W,94,10,8,2476,2570
YLL026W,20,10,9,2577,2597
YLL026W,66,10,10,2661,2727
YGL108C,35,1,1,193,228
YDR388W,24,1,1,784,808
YPL208W,27,5,1,365,392
YPL208W,48,5,2,872,920
YPL208W,17,5,3,1010,1027
YPL208W,55,5,4,1275,1330
YPL208W,26,5,5,1547,1573
YDR007W,47,1,1,308,355
YOR284W,20,1,1,615,635
YGL220W,24,1,1,260,284
YBR233W,62,1,1,648,710
YPL122C,23,1,1,231,254
YMR291W,36,10,1,585,621
YMR291W,22,10,2,811,833
YMR291W,19,10,3,885,904
YMR291W,37,10,4,1034,1071
YMR291W,18,10,5,1076,1094
YMR291W,24,10,6,1192,1216
YMR291W,17,10,7,1460,1477
YMR291W,22,10,8,1483,1505
YMR291W,17,10,9,1508,1525
YMR291W,50,10,10,1698,1748
YKL104C,24,13,1,470,494
YKL104C,26,13,2,580,606
YKL104C,20,13,3,926,946
YKL104C,28,13,4,949,977
YKL104C,17,13,5,1027,1044
YKL104C,23,13,6,1186,1209
YKL104C,18,13,7,1290,1308
YKL104C,16,13,8,1371,1387
YKL104C,17,13,9,1401,1418
YKL104C,30,13,10,1590,1620
YKL104C,24,13,11,1753,1777
YKL104C,34,13,12,1799,1833
YKL104C,74,13,13,2033,2107
YHR012W,32,4,1,200,232
YHR012W,22,4,2,470,492
YHR012W,44,4,3,511,555
YHR012W,46,4,4,794,840
YHL027W,30,8,1,398,428
YHL027W,19,8,2,436,455
YHL027W,39,8,3,542,581
YHL027W,19,8,4,1395,1414
YHL027W,15,8,5,1472,1487
YHL027W,26,8,6,1568,1594
YHL027W,19,8,7,1609,1628
YHL027W,16,8,8,1767,1783
YKL116C,29,8,1,468,497
YKL116C,20,8,2,517,537
YKL116C,20,8,3,916,936
YKL116C,40,8,4,978,1018
YKL116C,23,8,5,1141,1164
YKL116C,26,8,6,1179,1205
YKL116C,32,8,7,1321,1353
YKL116C,45,8,8,1422,1467
YOR319W,52,1,1,338,390
YGR119C,123,5,1,1022,1145
YGR119C,18,5,2,1151,1169
YGR119C,47,5,3,1257,1304
YGR119C,33,5,4,1362,1395
YGR119C,49,5,5,1410,1459
YGR035C,15,2,1,269,284
YGR035C,61,2,2,288,349
YOL127W,26,2,1,219,245
YOL127W,34,2,2,280,314
YAL020C,49,2,1,357,406
YAL020C,30,2,2,580,610
YDR539W,38,3,1,681,719
YDR539W,18,3,2,1033,1051
YDR539W,32,3,3,1472,1504
YMR212C,61,8,1,553,614
YMR212C,16,8,2,1093,1109
YMR212C,16,8,3,1129,1145
YMR212C,27,8,4,1137,1164
YMR212C,24,8,5,1503,1527
YMR212C,30,8,6,2090,2120
YMR212C,15,8,7,2205,2220
YMR212C,37,8,8,2258,2295
YBR025C,29,10,1,234,263
YBR025C,59,10,2,265,324
YBR025C,74,10,3,337,411
YBR025C,20,10,4,417,437
YBR025C,34,10,5,481,515
YBR025C,80,10,6,533,613
YBR025C,28,10,7,678,706
YBR025C,101,10,8,823,924
YBR025C,18,10,9,1082,1100
YBR025C,15,10,10,1106,1121
YML001W,58,1,1,347,405
YOR187W,26,2,1,415,441
YOR187W,25,2,2,1175,1200
YGR286C,33,1,1,384,417
YMR217W,19,6,1,269,288
YMR217W,79,6,2,460,539
YMR217W,66,6,3,989,1055
YMR217W,66,6,4,1075,1141
YMR217W,34,6,5,1238,1272
YMR217W,36,6,6,1542,1578
YKL128C,126,2,1,219,345
YKL128C,46,2,2,354,400
YGL035C,16,3,1,748,764
YGL035C,15,3,2,1054,1069
YGL035C,19,3,3,1092,1111
YCR086W,48,1,1,454,502
YDR494W,33,11,1,181,214
YDR494W,59,11,2,318,377
YDR494W,15,11,3,418,433
YDR494W,31,11,4,425,456
YDR494W,27,11,5,511,538
YDR494W,25,11,6,556,581
YDR494W,28,11,7,587,615
YDR494W,18,11,8,617,635
YDR494W,21,11,9,732,753
YDR494W,26,11,10,863,889
YDR494W,54,11,11,1026,1080
YLR026C,54,2,1,352,406
YLR026C,48,2,2,456,504
YGR246C,15,5,1,456,471
YGR246C,32,5,2,521,553
YGR246C,22,5,3,814,836
YGR246C,52,5,4,925,977
YGR246C,18,5,5,1371,1389
YHR008C,53,3,1,215,268
YHR008C,31,3,2,272,303
YHR008C,30,3,3,419,449
YMR277W,45,5,1,840,885
YMR277W,44,5,2,953,997
YMR277W,16,5,3,1038,1054
YMR277W,34,5,4,1128,1162
YMR277W,29,5,5,1709,1738
YLL004W,30,1,1,1466,1496
YER049W,20,3,1,1124,1144
YER049W,47,3,2,1323,1370
YER049W,27,3,3,1673,1700
YGL125W,40,5,1,1055,1095
YGL125W,54,5,2,1122,1176
YGL125W,18,5,3,1197,1215
YGL125W,16,5,4,1230,1246
YGL125W,34,5,5,1354,1388
YEL054C,54,1,1,315,369
YMR239C,23,8,1,491,514
YMR239C,28,8,2,791,819
YMR239C,31,8,3,817,848
YMR239C,61,8,4,937,998
YMR239C,16,8,5,1058,1074
YMR239C,57,8,6,1135,1192
YMR239C,28,8,7,1215,1243
YMR239C,50,8,8,1288,1338
YNL006W,81,4,1,287,368
YNL006W,66,4,2,377,443
YNL006W,26,4,3,447,473
YNL006W,33,4,4,507,540
YLR028C,44,10,1,641,685
YLR028C,67,10,2,728,795
YLR028C,20,10,3,1117,1137
YLR028C,36,10,4,1241,1277
YLR028C,46,10,5,1281,1327
YLR028C,37,10,6,1428,1465
YLR028C,21,10,7,1471,1492
YLR028C,47,10,8,1505,1552
YLR028C,16,10,9,1554,1570
YLR028C,21,10,10,1575,1596
YER136W,79,3,1,278,357
YER136W,16,3,2,439,455
YER136W,32,3,3,1019,1051
YML012W,34,3,1,163,197
YML012W,26,3,2,225,251
YML012W,19,3,3,559,578
YER056C-A,27,1,1,159,186
YDR028C,57,13,1,317,374
YDR028C,32,13,2,738,770
YDR028C,49,13,3,1560,1609
YDR028C,17,13,4,1659,1676
YDR028C,34,13,5,1676,1710
YDR028C,87,13,6,1911,1998
YDR028C,19,13,7,2081,2100
YDR028C,20,13,8,2196,2216
YDR028C,121,13,9,2549,2670
YDR028C,145,13,10,2673,2818
YDR028C,36,13,11,2819,2855
YDR028C,134,13,12,2856,2990
YDR028C,22,13,13,3023,3045
YOR217W,18,7,1,1181,1199
YOR217W,37,7,2,1255,1292
YOR217W,32,7,3,1604,1636
YOR217W,20,7,4,1638,1658
YOR217W,33,7,5,1783,1816
YOR217W,19,7,6,2041,2060
YOR217W,19,7,7,2432,2451
YMR285C,19,5,1,541,560
YMR285C,27,5,2,1170,1197
YMR285C,26,5,3,1354,1380
YMR285C,22,5,4,1381,1403
YMR285C,33,5,5,1422,1455
YPR074C,26,4,1,1005,1031
YPR074C,22,4,2,1035,1057
YPR074C,50,4,3,1493,1543
YPR074C,43,4,4,1628,1671
YCR057C,80,5,1,1299,1379
YCR057C,16,5,2,1403,1419
YCR057C,32,5,3,1743,1775
YCR057C,97,5,4,1900,1997
YCR057C,33,5,5,2186,2219
YMR197C,38,1,1,345,383
YAR071W,28,1,1,404,432
YLR060W,207,11,1,405,612
YLR060W,25,11,2,678,703
YLR060W,51,11,3,766,817
YLR060W,34,11,4,1099,1133
YLR060W,26,11,5,1314,1340
YLR060W,57,11,6,1406,1463
YLR060W,16,11,7,1464,1480
YLR060W,34,11,8,1498,1532
YLR060W,126,11,9,1538,1664
YLR060W,19,11,10,1746,1765
YLR060W,33,11,11,1752,1785
YDR516C,92,2,1,570,662
YDR516C,37,2,2,715,752
YPL233W,24,2,1,259,283
YPL233W,17,2,2,486,503
YIL063C,18,3,1,819,837
YIL063C,35,3,2,828,863
YIL063C,50,3,3,880,930
YIR006C,58,18,1,612,670
YIR006C,20,18,2,672,692
YIR006C,19,18,3,779,798
YIR006C,33,18,4,1059,1092
YIR006C,27,18,5,1700,1727
YIR006C,15,18,6,2020,2035
YIR006C,65,18,7,2661,2726
YIR006C,19,18,8,2866,2885
YIR006C,25,18,9,2886,2911
YIR006C,19,18,10,3072,3091
YIR006C,19,18,11,3332,3351
YIR006C,120,18,12,3401,3521
YIR006C,15,18,13,3643,3658
YIR006C,31,18,14,3660,3691
YIR006C,32,18,15,3817,3849
YIR006C,20,18,16,3872,3892
YIR006C,78,18,17,3908,3986
YIR006C,19,18,18,4044,4063
YBR049C,45,2,1,450,495
YBR049C,17,2,2,1492,1509
YDR044W,30,1,1,868,898
YKR080W,24,3,1,521,545
YKR080W,24,3,2,563,587
YKR080W,15,3,3,701,716
YNL010W,19,4,1,247,266
YNL010W,84,4,2,314,398
YNL010W,18,4,3,600,618
YNL010W,49,4,4,676,725
YDL002C,41,2,1,337,378
YDL002C,20,2,2,585,605
YJR032W,19,6,1,202,221
YJR032W,35,6,2,215,250
YJR032W,28,6,3,477,505
YJR032W,44,6,4,570,614
YJR032W,31,6,5,642,673
YJR032W,22,6,6,1109,1131
YIR037W,17,3,1,174,191
YIR037W,22,3,2,333,355
YIR037W,46,3,3,389,435
YDR071C,76,2,1,163,239
YDR071C,80,2,2,449,529
YDR162C,94,2,1,448,542
YDR162C,58,2,2,649,707
YJL101C,29,7,1,595,624
YJL101C,20,7,2,711,731
YJL101C,31,7,3,750,781
YJL101C,34,7,4,1133,1167
YJL101C,19,7,5,1463,1482
YJL101C,27,7,6,1565,1592
YJL101C,19,7,7,1936,1955
YDR353W,34,7,1,176,210
YDR353W,26,7,2,218,244
YDR353W,33,7,3,422,455
YDR353W,63,7,4,702,765
YDR353W,17,7,5,770,787
YDR353W,26,7,6,793,819
YDR353W,15,7,7,823,838
YMR139W,19,3,1,614,633
YMR139W,37,3,2,655,692
YMR139W,31,3,3,974,1005
YJL001W,90,4,1,200,290
YJL001W,113,4,2,291,404
YJL001W,44,4,3,420,464
YJL001W,33,4,4,550,583
YHR183W,100,2,1,335,435
YHR183W,39,2,2,1067,1106
YJL138C,44,7,1,284,328
YJL138C,23,7,2,395,418
YJL138C,15,7,3,606,621
YJL138C,46,7,4,704,750
YJL138C,61,7,5,751,812
YJL138C,32,7,6,923,955
YJL138C,40,7,7,957,997
YPR143W,17,1,1,715,732
YML085C,21,4,1,687,708
YML085C,103,4,2,909,1012
YML085C,33,4,3,1125,1158
YML085C,44,4,4,1282,1326
YOL080C,36,2,1,597,633
YOL080C,15,2,2,683,698
YER094C,81,3,1,285,366
YER094C,22,3,2,447,469
YER094C,31,3,3,463,494
YIL022W,16,4,1,604,620
YIL022W,52,4,2,977,1029
YIL022W,26,4,3,1189,1215
YIL022W,82,4,4,1208,1290
YHR083W,25,3,1,368,393
YHR083W,20,3,2,395,415
YHR083W,27,3,3,629,656
YKR037C,28,2,1,201,229
YKR037C,30,2,2,462,492
YKL119C,30,2,1,305,335
YKL119C,52,2,2,581,633
YLR212C,25,4,1,229,254
YLR212C,17,4,2,318,335
YLR212C,17,4,3,695,712
YLR212C,20,4,4,846,866
YHR042W,29,9,1,182,211
YHR042W,22,9,2,950,972
YHR042W,37,9,3,960,997
YHR042W,21,9,4,1009,1030
YHR042W,19,9,5,1110,1129
YHR042W,27,9,6,1130,1157
YHR042W,32,9,7,1227,1259
YHR042W,47,9,8,1481,1528
YHR042W,15,9,9,1799,1814
YER101C,27,3,1,342,369
YER101C,21,3,2,771,792
YER101C,41,3,3,963,1004
YKR079C,19,5,1,529,548
YKR079C,36,5,2,1125,1161
YKR079C,16,5,3,1429,1445
YKR079C,18,5,4,1857,1875
YKR079C,19,5,5,2171,2190
YNL248C,201,8,1,363,564
YNL248C,38,8,2,565,603
YNL248C,41,8,3,657,698
YNL248C,23,8,4,733,756
YNL248C,77,8,5,838,915
YNL248C,46,8,6,966,1012
YNL248C,46,8,7,1057,1103
YNL248C,77,8,8,1155,1232
YCR019W,16,1,1,724,740
YDR066C,32,1,1,458,490
YML030W,25,1,1,322,347
YML065W,45,6,1,687,732
YML065W,19,6,2,1979,1998
YML065W,30,6,3,2167,2197
YML065W,16,6,4,2245,2261
YML065W,15,6,5,2280,2295
YML065W,28,6,6,2526,2554
YPR165W,22,1,1,344,366
YGL194C-A,79,1,1,135,214
YPR125W,32,2,1,261,293
YPR125W,32,2,2,932,964
YHR049W,46,4,1,332,378
YHR049W,31,4,2,593,624
YHR049W,21,4,3,635,656
YHR049W,21,4,4,681,702
YDL126C,51,12,1,303,354
YDL126C,199,12,2,548,747
YDL126C,43,12,3,843,886
YDL126C,42,12,4,1089,1131
YDL126C,32,12,5,1192,1224
YDL126C,64,12,6,1427,1491
YDL126C,18,12,7,1719,1737
YDL126C,35,12,8,1795,1830
YDL126C,28,12,9,1839,1867
YDL126C,16,12,10,1874,1890
YDL126C,16,12,11,2150,2166
YDL126C,40,12,12,2169,2209
YDR228C,15,4,1,215,230
YDR228C,29,4,2,219,248
YDR228C,21,4,3,1134,1155
YDR228C,28,4,4,1156,1184
YOR340C,28,2,1,693,721
YOR340C,64,2,2,842,906
YGR264C,43,10,1,691,734
YGR264C,29,10,2,742,771
YGR264C,22,10,3,818,840
YGR264C,22,10,4,906,928
YGR264C,16,10,5,933,949
YGR264C,38,10,6,1394,1432
YGR264C,15,10,7,1519,1534
YGR264C,69,10,8,1537,1606
YGR264C,70,10,9,1911,1981
YGR264C,39,10,10,1985,2024
YOR133W,44,18,1,189,233
YOR133W,55,18,2,335,390
YOR133W,38,18,3,402,440
YOR133W,15,18,4,488,503
YOR133W,43,18,5,571,614
YOR133W,84,18,6,1065,1149
YOR133W,25,18,7,1177,1202
YOR133W,95,18,8,1238,1333
YOR133W,18,18,9,1446,1464
YOR133W,51,18,10,1574,1625
YOR133W,34,18,11,1664,1698
YOR133W,45,18,12,1966,2011
YOR133W,86,18,13,2015,2101
YOR133W,40,18,14,2114,2154
YOR133W,40,18,15,2188,2228
YOR133W,36,18,16,2233,2269
YOR133W,20,18,17,2282,2302
YOR133W,68,18,18,2428,2496
YNL320W,24,1,1,292,316
YBR145W,20,2,1,215,235
YBR145W,34,2,2,604,638
YDR339C,31,1,1,312,343
YNL310C,29,2,1,196,225
YNL310C,34,2,2,488,522
YFL037W,20,6,1,645,665
YFL037W,27,6,2,677,704
YFL037W,101,6,3,1062,1163
YFL037W,75,6,4,1181,1256
YFL037W,20,6,5,1277,1297
YFL037W,28,6,6,1303,1331
YJR132W,43,12,1,304,347
YJR132W,19,12,2,514,533
YJR132W,20,12,3,626,646
YJR132W,34,12,4,892,926
YJR132W,46,12,5,960,1006
YJR132W,23,12,6,1260,1283
YJR132W,66,12,7,1322,1388
YJR132W,40,12,8,1377,1417
YJR132W,23,12,9,2591,2614
YJR132W,70,12,10,2688,2758
YJR132W,20,12,11,2759,2779
YJR132W,29,12,12,2841,2870
YPL169C,22,2,1,1187,1209
YPL169C,27,2,2,1507,1534
YHR161C,45,2,1,1134,1179
YHR161C,16,2,2,1180,1196
YNL199C,43,1,1,604,647
YLR181C,27,4,1,402,429
YLR181C,28,4,2,464,492
YLR181C,43,4,3,497,540
YLR181C,47,4,4,582,629
YLR225C,17,2,1,337,354
YLR225C,37,2,2,1103,1140
YGL207W,27,19,1,647,674
YGL207W,33,19,2,944,977
YGL207W,73,19,3,978,1051
YGL207W,34,19,4,1159,1193
YGL207W,18,19,5,1382,1400
YGL207W,38,19,6,1586,1624
YGL207W,37,19,7,1763,1800
YGL207W,31,19,8,1806,1837
YGL207W,65,19,9,1849,1914
YGL207W,41,19,10,2014,2055
YGL207W,19,19,11,2056,2075
YGL207W,44,19,12,2184,2228
YGL207W,17,19,13,2339,2356
YGL207W,29,19,14,2343,2372
YGL207W,59,19,15,2387,2446
YGL207W,21,19,16,2447,2468
YGL207W,26,19,17,2688,2714
YGL207W,36,19,18,2724,2760
YGL207W,25,19,19,2781,2806
YLR270W,17,5,1,323,340
YLR270W,37,5,2,417,454
YLR270W,41,5,3,492,533
YLR270W,24,5,4,658,682
YLR270W,24,5,5,800,824
YIL050W,30,3,1,416,446
YIL050W,17,3,2,592,609
YIL050W,34,3,3,611,645
YLR309C,60,6,1,264,324
YLR309C,17,6,2,1554,1571
YLR309C,37,6,3,1988,2025
YLR309C,30,6,4,2026,2056
YLR309C,35,6,5,2098,2133
YLR309C,53,6,6,2282,2335
YPR086W,30,2,1,921,951
YPR086W,31,2,2,958,989
YIL068C,42,4,1,244,286
YIL068C,66,4,2,369,435
YIL068C,29,4,3,651,680
YIL068C,27,4,4,827,854
YDR153C,16,2,1,309,325
YDR153C,51,2,2,434,485
YJL065C,24,2,1,291,315
YJL065C,33,2,2,461,494
YPL127C,42,5,1,338,380
YPL127C,18,5,2,473,491
YPL127C,24,5,3,594,618
YPL127C,25,5,4,735,760
YPL127C,16,5,5,761,777
YJR003C,59,2,1,1178,1237
YJR003C,17,2,2,1246,1263
YDL144C,30,2,1,237,267
YDL144C,25,2,2,395,420
YFL028C,30,5,1,408,438
YFL028C,15,5,2,543,558
YFL028C,52,5,3,587,639
YFL028C,26,5,4,684,710
YFL028C,33,5,5,711,744
YPL117C,16,4,1,350,366
YPL117C,46,4,2,506,552
YPL117C,41,4,3,604,645
YPL117C,60,4,4,807,867
YNL062C,26,5,1,172,198
YNL062C,36,5,2,369,405
YNL062C,22,5,3,413,435
YNL062C,23,5,4,1159,1182
YNL062C,75,5,5,1362,1437
YMR295C,15,2,1,495,510
YMR295C,51,2,2,539,590
YBR118W,44,8,1,340,384
YBR118W,44,8,2,386,430
YBR118W,33,8,3,660,693
YBR118W,25,8,4,857,882
YBR118W,69,8,5,984,1053
YBR118W,82,8,6,1082,1164
YBR118W,29,8,7,1172,1201
YBR118W,20,8,8,1300,1320
YDR324C,15,5,1,761,776
YDR324C,16,5,2,1129,1145
YDR324C,57,5,3,1137,1194
YDR324C,26,5,4,1797,1823
YDR324C,33,5,5,2060,2093
YLR389C,63,3,1,1059,1122
YLR389C,21,3,2,1945,1966
YLR389C,19,3,3,2951,2970
YOR112W,26,13,1,201,227
YOR112W,37,13,2,248,285
YOR112W,25,13,3,427,452
YOR112W,38,13,4,640,678
YOR112W,26,13,5,1106,1132
YOR112W,32,13,6,1449,1481
YOR112W,20,13,7,1545,1565
YOR112W,32,13,8,1619,1651
YOR112W,23,13,9,1652,1675
YOR112W,39,13,10,1677,1716
YOR112W,17,13,11,1946,1963
YOR112W,21,13,12,2104,2125
YOR112W,17,13,13,2234,2251
YGR157W,22,3,1,288,310
YGR157W,30,3,2,326,356
YGR157W,15,3,3,2380,2395
YDL168W,60,15,1,163,223
YDL168W,54,15,2,224,278
YDL168W,19,15,3,279,298
YDL168W,108,15,4,307,415
YDL168W,66,15,5,416,482
YDL168W,31,15,6,484,515
YDL168W,85,15,7,523,608
YDL168W,30,15,8,609,639
YDL168W,39,15,9,630,669
YDL168W,103,15,10,753,856
YDL168W,40,15,11,857,897
YDL168W,28,15,12,898,926
YDL168W,23,15,13,930,953
YDL168W,46,15,14,981,1027
YDL168W,18,15,15,1139,1157
YKL144C,28,5,1,179,207
YKL144C,26,5,2,265,291
YKL144C,38,5,3,294,332
YKL144C,24,5,4,333,357
YKL144C,70,5,5,564,634
YNL175C,48,3,1,550,598
YNL175C,39,3,2,648,687
YNL175C,30,3,3,966,996
YGR173W,30,3,1,350,380
YGR173W,52,3,2,846,898
YGR173W,88,3,3,997,1085
YBR234C,27,4,1,170,197
YBR234C,45,4,2,243,288
YBR234C,50,4,3,299,349
YBR234C,25,4,4,365,390
YOR061W,111,5,1,323,434
YOR061W,31,5,2,521,552
YOR061W,21,5,3,624,645
YOR061W,18,5,4,745,763
YOR061W,20,5,5,842,862
YOR356W,53,5,1,246,299
YOR356W,24,5,2,668,692
YOR356W,29,5,3,976,1005
YOR356W,38,5,4,1121,1159
YOR356W,51,5,5,1203,1254
YBR193C,26,1,1,462,488
YBR261C,33,2,1,406,439
YBR261C,20,2,2,452,472
YAR027W,37,2,1,247,284
YAR027W,36,2,2,271,307
YHR013C,43,2,1,515,558
YHR013C,30,2,2,606,636
YGR083C,31,1,1,1691,1722
YOL146W,52,2,1,202,254
YOL146W,33,2,2,246,279
YGL221C,30,2,1,261,291
YGL221C,49,2,2,433,482
YHR144C,52,1,1,365,417
YDR190C,16,6,1,396,412
YDR190C,59,6,2,853,912
YDR190C,29,6,3,925,954
YDR190C,66,6,4,959,1025
YDR190C,28,6,5,1181,1209
YDR190C,32,6,6,1284,1316
YNL290W,37,2,1,251,288
YNL290W,20,2,2,603,623
YOR131C,46,2,1,457,503
YOR131C,15,2,2,597,612
YGR123C,24,4,1,193,217
YGR123C,43,4,2,359,402
YGR123C,35,4,3,390,425
YGR123C,30,4,4,753,783
YPR060C,31,1,1,665,696
YMR314W,16,1,1,298,314
YLR455W,30,3,1,269,299
YLR455W,22,3,2,301,323
YLR455W,107,3,3,324,431
YAL021C,33,12,1,1095,1128
YAL021C,67,12,2,1115,1182
YAL021C,45,12,3,1192,1237
YAL021C,37,12,4,1268,1305
YAL021C,78,12,5,1335,1413
YAL021C,97,12,6,1461,1558
YAL021C,84,12,7,1667,1751
YAL021C,29,12,8,1808,1837
YAL021C,24,12,9,1869,1893
YAL021C,36,12,10,2105,2141
YAL021C,39,12,11,2333,2372
YAL021C,49,12,12,2465,2514
YNL247W,42,16,1,257,299
YNL247W,37,16,2,300,337
YNL247W,75,16,3,446,521
YNL247W,26,16,4,691,717
YNL247W,27,16,5,758,785
YNL247W,29,16,6,830,859
YNL247W,68,16,7,910,978
YNL247W,74,16,8,1049,1123
YNL247W,30,16,9,1553,1583
YNL247W,23,16,10,1721,1744
YNL247W,39,16,11,1826,1865
YNL247W,58,16,12,1927,1985
YNL247W,17,16,13,1986,2003
YNL247W,19,16,14,2004,2023
YNL247W,33,16,15,2063,2096
YNL247W,36,16,16,2268,2304
YHR128W,81,1,1,437,518
YOL126C,15,2,1,270,285
YOL126C,15,2,2,933,948
YCL011C,36,4,1,210,246
YCL011C,70,4,2,255,325
YCL011C,29,4,3,401,430
YCL011C,23,4,4,431,454
YMR184W,98,4,1,284,382
YMR184W,16,4,2,391,407
YMR184W,59,4,3,504,563
YMR184W,22,4,4,571,593
YBR123C,25,15,1,444,469
YBR123C,38,15,2,481,519
YBR123C,17,15,3,529,546
YBR123C,15,15,4,549,564
YBR123C,18,15,5,572,590
YBR123C,30,15,6,606,636
YBR123C,16,15,7,773,789
YBR123C,58,15,8,856,914
YBR123C,30,15,9,923,953
YBR123C,22,15,10,955,977
YBR123C,32,15,11,1017,1049
YBR123C,34,15,12,1150,1184
YBR123C,24,15,13,1287,1311
YBR123C,21,15,14,1338,1359
YBR123C,23,15,15,1673,1696
YPL118W,38,2,1,378,416
YPL118W,32,2,2,497,529
YGR090W,43,23,1,458,501
YGR090W,15,23,2,815,830
YGR090W,18,23,3,909,927
YGR090W,52,23,4,931,983
YGR090W,41,23,5,1054,1095
YGR090W,16,23,6,1099,1115
YGR090W,31,23,7,1232,1263
YGR090W,35,23,8,1458,1493
YGR090W,72,23,9,1691,1763
YGR090W,24,23,10,1904,1928
YGR090W,90,23,11,1932,2022
YGR090W,26,23,12,2058,2084
YGR090W,28,23,13,2115,2143
YGR090W,24,23,14,2361,2385
YGR090W,24,23,15,2387,2411
YGR090W,64,23,16,2418,2482
YGR090W,25,23,17,2750,2775
YGR090W,18,23,18,2808,2826
YGR090W,34,23,19,2864,2898
YGR090W,37,23,20,2929,2966
YGR090W,26,23,21,2969,2995
YGR090W,27,23,22,3286,3313
YGR090W,47,23,23,3667,3714
YDL233W,43,2,1,555,598
YDL233W,16,2,2,1156,1172
YFR028C,15,5,1,315,330
YFR028C,126,5,2,354,480
YFR028C,25,5,3,831,856
YFR028C,35,5,4,1114,1149
YFR028C,17,5,5,1172,1189
YDL188C,36,5,1,452,488
YDL188C,45,5,2,652,697
YDL188C,21,5,3,729,750
YDL188C,70,5,4,752,822
YDL188C,19,5,5,1102,1121
YOR043W,66,4,1,662,728
YOR043W,30,4,2,1024,1054
YOR043W,27,4,3,1379,1406
YOR043W,27,4,4,1418,1445
YDR470C,41,3,1,182,223
YDR470C,119,3,2,212,331
YDR470C,41,3,3,336,377
YIL034C,56,6,1,297,353
YIL034C,66,6,2,354,420
YIL034C,17,6,3,463,480
YIL034C,61,6,4,550,611
YIL034C,15,6,5,618,633
YIL034C,47,6,6,660,707
YIL043C,20,1,1,573,593
YPL134C,64,2,1,155,219
YPL134C,24,2,2,494,518
YJL087C,41,10,1,303,344
YJL087C,29,10,2,367,396
YJL087C,17,10,3,679,696
YJL087C,15,10,4,697,712
YJL087C,21,10,5,1390,1411
YJL087C,28,10,6,1648,1676
YJL087C,16,10,7,1736,1752
YJL087C,25,10,8,2076,2101
YJL087C,47,10,9,2236,2283
YJL087C,20,10,10,2365,2385
YLR347C,24,2,1,713,737
YLR347C,22,2,2,895,917
YDR292C,37,2,1,1305,1342
YDR292C,15,2,2,1360,1375
YNL157W,18,3,1,410,428
YNL157W,27,3,2,429,456
YNL157W,33,3,3,451,484
YKR072C,20,19,1,465,485
YKR072C,21,19,2,491,512
YKR072C,49,19,3,509,558
YKR072C,15,19,4,718,733
YKR072C,125,19,5,739,864
YKR072C,18,19,6,942,960
YKR072C,101,19,7,967,1068
YKR072C,26,19,8,1077,1103
YKR072C,18,19,9,1152,1170
YKR072C,70,19,10,1172,1242
YKR072C,54,19,11,1281,1335
YKR072C,15,19,12,1344,1359
YKR072C,59,19,13,1362,1421
YKR072C,24,19,14,1422,1446
YKR072C,19,19,15,1458,1477
YKR072C,21,19,16,1482,1503
YKR072C,39,19,17,1490,1529
YKR072C,53,19,18,1554,1607
YKR072C,22,19,19,1660,1682
YNL137C,29,2,1,525,554
YNL137C,46,2,2,1166,1212
YAL036C,22,5,1,366,388
YAL036C,21,5,2,434,455
YAL036C,70,5,3,457,527
YAL036C,58,5,4,995,1053
YAL036C,46,5,5,1062,1108
YML120C,15,5,1,207,222
YML120C,19,5,2,317,336
YML120C,16,5,3,569,585
YML120C,16,5,4,868,884
YML120C,21,5,5,1179,1200
YNL164C,20,2,1,951,971
YNL164C,37,2,2,958,995
YHR208W,32,11,1,252,284
YHR208W,144,11,2,298,442
YHR208W,51,11,3,583,634
YHR208W,25,11,4,683,708
YHR208W,36,11,5,710,746
YHR208W,21,11,6,747,768
YHR208W,19,11,7,817,836
YHR208W,44,11,8,839,883
YHR208W,45,11,9,919,964
YHR208W,35,11,10,969,1004
YHR208W,37,11,11,991,1028
YDL065C,61,1,1,933,994
YGL244W,87,2,1,645,732
YGL244W,62,2,2,1156,1218
YBR035C,21,1,1,555,576
YOR239W,19,2,1,1343,1362
YOR239W,54,2,2,1793,1847
YBL036C,26,4,1,368,394
YBL036C,61,4,2,422,483
YBL036C,68,4,3,649,717
YBL036C,30,4,4,743,773
YBR080C,31,5,1,507,538
YBR080C,15,5,2,552,567
YBR080C,50,5,3,800,850
YBR080C,15,5,4,1818,1833
YBR080C,56,5,5,2067,2123
YPR191W,27,11,1,281,308
YPR191W,22,11,2,343,365
YPR191W,65,11,3,378,443
YPR191W,30,11,4,490,520
YPR191W,24,11,5,549,573
YPR191W,52,11,6,575,627
YPR191W,39,11,7,614,653
YPR191W,21,11,8,740,761
YPR191W,33,11,9,779,812
YPR191W,58,11,10,832,890
YPR191W,43,11,11,1005,1048
YJL020C,26,2,1,188,214
YJL020C,37,2,2,3003,3040
YER117W,54,1,1,305,359
YDR027C,16,9,1,312,328
YDR027C,27,9,2,353,380
YDR027C,26,9,3,393,419
YDR027C,15,9,4,949,964
YDR027C,35,9,5,1426,1461
YDR027C,24,9,6,1463,1487
YDR027C,33,9,7,1492,1525
YDR027C,35,9,8,1625,1660
YDR027C,30,9,9,2569,2599
YJL110C,28,6,1,178,206
YJL110C,21,6,2,324,345
YJL110C,18,6,3,784,802
YJL110C,29,6,4,977,1006
YJL110C,24,6,5,1149,1173
YJL110C,19,6,6,1200,1219
YHR068W,35,4,1,485,520
YHR068W,65,4,2,557,622
YHR068W,44,4,3,699,743
YHR068W,27,4,4,858,885
YER071C,39,2,1,197,236
YER071C,16,2,2,360,376
YNL272C,15,2,1,848,863
YNL272C,27,2,2,1722,1749
YBR048W,29,2,1,326,355
YBR048W,39,2,2,396,435
YKL218C,17,2,1,300,317
YKL218C,16,2,2,693,709
YKR081C,45,1,1,141,186
YPL263C,37,4,1,827,864
YPL263C,19,4,2,979,998
YPL263C,44,4,3,1223,1267
YPL263C,25,4,4,1471,1496
YGR001C,17,2,1,322,339
YGR001C,20,2,2,600,620
YDL001W,22,2,1,909,931
YDL001W,54,2,2,932,986
YOR140W,22,3,1,699,721
YOR140W,29,3,2,1746,1775
YOR140W,18,3,3,1996,2014
YPL218W,40,2,1,233,273
YPL218W,27,2,2,365,392
YGR250C,23,9,1,316,339
YGR250C,15,9,2,486,501
YGR250C,20,9,3,502,522
YGR250C,21,9,4,523,544
YGR250C,19,9,5,604,623
YGR250C,18,9,6,631,649
YGR250C,41,9,7,1057,1098
YGR250C,27,9,8,1856,1883
YGR250C,31,9,9,1928,1959
YOR254C,35,1,1,280,315
YMR309C,64,6,1,1308,1372
YMR309C,57,6,2,1406,1463
YMR309C,43,6,3,1633,1676
YMR309C,39,6,4,1930,1969
YMR309C,32,6,5,2218,2250
YMR309C,16,6,6,2301,2317
YOR089C,55,3,1,158,213
YOR089C,51,3,2,279,330
YOR089C,79,3,3,392,471
YOR230W,77,3,1,576,653
YOR230W,35,3,2,813,848
YOR230W,82,3,3,994,1076
YBR166C,67,7,1,447,514
YBR166C,39,7,2,811,850
YBR166C,21,7,3,874,895
YBR166C,42,7,4,1050,1092
YBR166C,44,7,5,1093,1137
YBR166C,35,7,6,1172,1207
YBR166C,36,7,7,1278,1314
YNL258C,53,2,1,1756,1809
YNL258C,28,2,2,2153,2181
YKL216W,48,3,1,501,549
YKL216W,99,3,2,600,699
YKL216W,175,3,3,742,917
YBL021C,30,1,1,404,434
YLL045C,159,3,1,270,429
YLL045C,61,3,2,541,602
YLL045C,44,3,3,675,719
YOR209C,46,3,1,467,513
YOR209C,45,3,2,809,854
YOR209C,26,3,3,1135,1161
YLR007W,39,2,1,411,450
YLR007W,19,2,2,726,745
YML102W,49,7,1,250,299
YML102W,31,7,2,452,483
YML102W,49,7,3,503,552
YML102W,18,7,4,794,812
YML102W,15,7,5,946,961
YML102W,30,7,6,992,1022
YML102W,23,7,7,1122,1145
YER157W,19,8,1,736,755
YER157W,15,8,2,1055,1070
YER157W,35,8,3,1225,1260
YER157W,30,8,4,1298,1328
YER157W,31,8,5,1440,1471
YER157W,15,8,6,2255,2270
YER157W,23,8,7,2273,2296
YER157W,20,8,8,2297,2317
YOL022C,21,4,1,546,567
YOL022C,15,4,2,983,998
YOL022C,57,4,3,1041,1098
YOL022C,30,4,4,1086,1116
YGR270W,17,5,1,1558,1575
YGR270W,46,5,2,1615,1661
YGR270W,23,5,3,2015,2038
YGR270W,20,5,4,2901,2921
YGR270W,15,5,5,3308,3323
YEL037C,37,1,1,946,983
YDR389W,41,8,1,671,712
YDR389W,67,8,2,821,888
YDR389W,42,8,3,921,963
YDR389W,25,8,4,1189,1214
YDR389W,19,8,5,1572,1591
YDR389W,37,8,6,1590,1627
YDR389W,15,8,7,1874,1889
YDR389W,37,8,8,1885,1922
YMR054W,50,4,1,170,220
YMR054W,30,4,2,221,251
YMR054W,33,4,3,619,652
YMR054W,27,4,4,657,684
YJR121W,147,10,1,211,358
YJR121W,44,10,2,369,413
YJR121W,44,10,3,415,459
YJR121W,64,10,4,668,732
YJR121W,55,10,5,1225,1280
YJR121W,27,10,6,1285,1312
YJR121W,18,10,7,1317,1335
YJR121W,39,10,8,1342,1381
YJR121W,19,10,9,1387,1406
YJR121W,92,10,10,1444,1536
YCL050C,23,2,1,432,455
YCL050C,43,2,2,881,924
YGR047C,27,3,1,819,846
YGR047C,31,3,2,872,903
YGR047C,49,3,3,1167,1216
YJL148W,44,2,1,236,280
YJL148W,63,2,2,577,640
YGL008C,27,2,1,488,515
YGL008C,94,2,2,1497,1591
YJL026W,20,2,1,415,435
YJL026W,69,2,2,941,1010
YLR412W,20,1,1,374,394
YER002W,24,3,1,335,359
YER002W,39,3,2,567,606
YER002W,59,3,3,636,695
YDR170C,31,23,1,983,1014
YDR170C,54,23,2,1026,1080
YDR170C,23,23,3,1081,1104
YDR170C,15,23,4,1302,1317
YDR170C,36,23,5,1428,1464
YDR170C,28,23,6,1650,1678
YDR170C,37,23,7,1697,1734
YDR170C,24,23,8,1812,1836
YDR170C,25,23,9,1911,1936
YDR170C,37,23,10,1994,2031
YDR170C,36,23,11,2185,2221
YDR170C,27,23,12,3690,3717
YDR170C,42,23,13,4103,4145
YDR170C,40,23,14,4185,4225
YDR170C,40,23,15,4280,4320
YDR170C,30,23,16,4321,4351
YDR170C,19,23,17,4457,4476
YDR170C,33,23,18,4813,4846
YDR170C,17,23,19,5100,5117
YDR170C,21,23,20,5135,5156
YDR170C,57,23,21,5646,5703
YDR170C,29,23,22,5781,5810
YDR170C,22,23,23,5948,5970
YDL127W,26,1,1,404,430
YDR272W,62,3,1,478,540
YDR272W,38,3,2,551,589
YDR272W,18,3,3,719,737
YOR159C,36,3,1,152,188
YOR159C,30,3,2,189,219
YOR159C,43,3,3,237,280
YOR160W,25,7,1,892,917
YOR160W,17,7,2,984,1001
YOR160W,17,7,3,1007,1024
YOR160W,44,7,4,1148,1192
YOR160W,31,7,5,1684,1715
YOR160W,15,7,6,1902,1917
YOR160W,16,7,7,2809,2825
YOR294W,32,1,1,506,538
YMR261C,43,18,1,590,633
YMR261C,21,18,2,788,809
YMR261C,69,18,3,1002,1071
YMR261C,19,18,4,1077,1096
YMR261C,41,18,5,1140,1181
YMR261C,15,18,6,1276,1291
YMR261C,40,18,7,1330,1370
YMR261C,36,18,8,1455,1491
YMR261C,27,18,9,1521,1548
YMR261C,42,18,10,1616,1658
YMR261C,33,18,11,1863,1896
YMR261C,28,18,12,1988,2016
YMR261C,68,18,13,2220,2288
YMR261C,48,18,14,2495,2543
YMR261C,16,18,15,2607,2623
YMR261C,31,18,16,2692,2723
YMR261C,21,18,17,2806,2827
YMR261C,23,18,18,2838,2861
YMR112C,31,1,1,338,369
YJL039C,63,9,1,882,945
YJL039C,73,9,2,1584,1657
YJL039C,37,9,3,1658,1695
YJL039C,18,9,4,1766,1784
YJL039C,17,9,5,1829,1846
YJL039C,29,9,6,2442,2471
YJL039C,15,9,7,3563,3578
YJL039C,42,9,8,3704,3746
YJL039C,26,9,9,3782,3808
YBR006W,24,3,1,830,854
YBR006W,36,3,2,981,1017
YBR006W,28,3,3,1400,1428
YNL096C,70,3,1,248,318
YNL096C,48,3,2,341,389
YNL096C,28,3,3,405,433
YNL212W,19,5,1,860,879
YNL212W,18,5,2,1092,1110
YNL212W,20,5,3,1111,1131
YNL212W,54,5,4,1889,1943
YNL212W,31,5,5,2098,2129
YMR216C,27,5,1,564,591
YMR216C,89,5,2,620,709
YMR216C,44,5,3,759,803
YMR216C,20,5,4,1012,1032
YMR216C,24,5,5,1029,1053
YMR170C,43,2,1,1195,1238
YMR170C,27,2,2,1361,1388
YNL253W,19,1,1,911,930
YBR024W,64,2,1,246,310
YBR024W,21,2,2,311,332
YDR502C,31,6,1,329,360
YDR502C,20,6,2,650,670
YDR502C,87,6,3,735,822
YDR502C,72,6,4,833,905
YDR502C,31,6,5,971,1002
YDR502C,43,6,6,1025,1068
YOR238W,15,1,1,305,320
YER062C,34,3,1,421,455
YER062C,29,3,2,456,485
YER062C,49,3,3,501,550
YDL047W,17,4,1,250,267
YDL047W,15,4,2,446,461
YDL047W,21,4,3,544,565
YDL047W,26,4,4,884,910
YDR101C,39,12,1,843,882
YDR101C,26,12,2,1242,1268
YDR101C,23,12,3,1275,1298
YDR101C,26,12,4,1302,1328
YDR101C,58,12,5,1421,1479
YDR101C,20,12,6,1480,1500
YDR101C,32,12,7,1521,1553
YDR101C,38,12,8,1564,1602
YDR101C,18,12,9,1653,1671
YDR101C,42,12,10,1665,1707
YDR101C,57,12,11,1709,1766
YDR101C,29,12,12,1753,1782
YLR025W,68,1,1,295,363
YBR066C,17,2,1,562,579
YBR066C,18,2,2,626,644
YDR341C,23,6,1,542,565
YDR341C,24,6,2,653,677
YDR341C,71,6,3,758,829
YDR341C,96,6,4,878,974
YDR341C,45,6,5,1040,1085
YDR341C,62,6,6,1755,1817
YKL027W,50,3,1,203,253
YKL027W,34,3,2,255,289
YKL027W,26,3,3,1109,1135
YBR079C,15,7,1,888,903
YBR079C,38,7,2,1347,1385
YBR079C,19,7,3,1594,1613
YBR079C,30,7,4,1602,1632
YBR079C,42,7,5,1866,1908
YBR079C,43,7,6,2111,2154
YBR079C,18,7,7,2169,2187
YHR199C,34,2,1,770,804
YHR199C,15,2,2,848,863
YDL090C,27,1,1,846,873
YMR061W,15,7,1,252,267
YMR061W,32,7,2,297,329
YMR061W,16,7,3,532,548
YMR061W,37,7,4,549,586
YMR061W,15,7,5,698,713
YMR061W,59,7,6,725,784
YMR061W,26,7,7,1304,1330
YJL128C,34,3,1,717,751
YJL128C,32,3,2,1730,1762
YJL128C,20,3,3,1937,1957
YJR002W,55,8,1,205,260
YJR002W,28,8,2,385,413
YJR002W,26,8,3,883,909
YJR002W,16,8,4,1081,1097
YJR002W,25,8,5,1151,1176
YJR002W,17,8,6,1178,1195
YJR002W,26,8,7,1199,1225
YJR002W,29,8,8,1676,1705
YDL145C,18,24,1,209,227
YDL145C,52,24,2,291,343
YDL145C,27,24,3,480,507
YDL145C,82,24,4,532,614
YDL145C,121,24,5,812,933
YDL145C,22,24,6,1002,1024
YDL145C,35,24,7,1186,1221
YDL145C,50,24,8,1244,1294
YDL145C,15,24,9,1303,1318
YDL145C,78,24,10,1401,1479
YDL145C,58,24,11,1490,1548
YDL145C,48,24,12,1577,1625
YDL145C,22,24,13,1657,1679
YDL145C,23,24,14,1683,1706
YDL145C,23,24,15,1735,1758
YDL145C,44,24,16,1771,1815
YDL145C,49,24,17,1851,1900
YDL145C,34,24,18,2077,2111
YDL145C,28,24,19,2501,2529
YDL145C,25,24,20,2844,2869
YDL145C,33,24,21,2963,2996
YDL145C,26,24,22,3017,3043
YDL145C,51,24,23,3048,3099
YDL145C,46,24,24,3104,3150
YKL127W,75,2,1,1131,1206
YKL127W,34,2,2,1678,1712
YDR309C,82,3,1,838,920
YDR309C,20,3,2,939,959
YDR309C,17,3,3,1094,1111
YNL061W,40,3,1,286,326
YNL061W,34,3,2,375,409
YNL061W,18,3,3,1694,1712
YDR398W,35,4,1,206,241
YDR398W,41,4,2,313,354
YDR398W,16,4,3,375,391
YDR398W,17,4,4,1074,1091
YGL068W,78,1,1,273,351
YDR457W,17,22,1,613,630
YDR457W,15,22,2,731,746
YDR457W,25,22,3,1210,1235
YDR457W,62,22,4,1319,1381
YDR457W,38,22,5,1416,1454
YDR457W,18,22,6,1692,1710
YDR457W,26,22,7,1715,1741
YDR457W,43,22,8,1824,1867
YDR457W,31,22,9,2064,2095
YDR457W,22,22,10,2616,2638
YDR457W,40,22,11,2643,2683
YDR457W,39,22,12,2813,2852
YDR457W,17,22,13,2973,2990
YDR457W,32,22,14,3005,3037
YDR457W,22,22,15,3654,3676
YDR457W,19,22,16,3904,3923
YDR457W,34,22,17,5216,5250
YDR457W,21,22,18,5431,5452
YDR457W,30,22,19,7016,7046
YDR457W,27,22,20,7472,7499
YDR457W,15,22,21,8455,8470
YDR457W,26,22,22,9431,9457
YIL135C,36,2,1,720,756
YIL135C,16,2,2,758,774
YKL067W,44,1,1,245,289
YMR005W,17,3,1,673,690
YMR005W,66,3,2,935,1001
YMR005W,31,3,3,993,1024
YLR262C,18,1,1,579,597
YNL121C,47,5,1,987,1034
YNL121C,58,5,2,1052,1110
YNL121C,37,5,3,1325,1362
YNL121C,30,5,4,1433,1463
YNL121C,56,5,5,1659,1715
YDR087C,22,1,1,579,601
YBR081C,30,4,1,996,1026
YBR081C,23,4,2,1050,1073
YBR081C,16,4,3,2420,2436
YBR081C,38,4,4,3580,3618
YJL166W,77,1,1,208,285
YER044C,17,1,1,184,201
YLR248W,22,9,1,707,729
YLR248W,21,9,2,781,802
YLR248W,21,9,3,803,824
YLR248W,26,9,4,835,861
YLR248W,15,9,5,1067,1082
YLR248W,101,9,6,1109,1210
YLR248W,15,9,7,1211,1226
YLR248W,37,9,8,1338,1375
YLR248W,34,9,9,1443,1477
YOR283W,37,2,1,352,389
YOR283W,56,2,2,400,456
YLR009W,38,1,1,232,270
YCR020W-B,39,1,1,191,230
YBL068W,16,3,1,290,306
YBL068W,32,3,2,381,413
YBL068W,30,3,3,634,664
YGL011C,27,2,1,246,273
YGL011C,46,2,2,492,538
YIR036C,20,4,1,443,463
YIR036C,33,4,2,570,603
YIR036C,46,4,3,637,683
YIR036C,16,4,4,685,701
YKL129C,28,3,1,1016,1044
YKL129C,16,3,2,1985,2001
YKL129C,35,3,3,2431,2466
YMR123W,78,1,1,132,210
YDR238C,41,7,1,498,539
YDR238C,45,7,2,561,606
YDR238C,50,7,3,1127,1177
YDR238C,50,7,4,1488,1538
YDR238C,22,7,5,2059,2081
YDR238C,25,7,6,2700,2725
YDR238C,16,7,7,2778,2794
YOR128C,31,6,1,396,427
YOR128C,22,6,2,827,849
YOR128C,17,6,3,931,948
YOR128C,33,6,4,1330,1363
YOR128C,22,6,5,1381,1403
YOR128C,27,6,6,1511,1538
YFR031C-A,75,3,1,328,403
YFR031C-A,74,3,2,561,635
YFR031C-A,33,3,3,669,702
YDR243C,19,5,1,657,676
YDR243C,29,5,2,754,783
YDR243C,19,5,3,1414,1433
YDR243C,16,5,4,1437,1453
YDR243C,17,5,5,1574,1591
YHR082C,18,5,1,245,263
YHR082C,19,5,2,268,287
YHR082C,30,5,3,282,312
YHR082C,23,5,4,1075,1098
YHR082C,16,5,5,1234,1250
YGR209C,74,1,1,215,289
YIL030C,35,1,1,293,328
YLR183C,18,7,1,435,453
YLR183C,22,7,2,678,700
YLR183C,18,7,3,706,724
YLR183C,16,7,4,735,751
YLR183C,44,7,5,771,815
YLR183C,24,7,6,813,837
YLR183C,25,7,7,1251,1276
YNL050C,38,1,1,769,807
YBR251W,21,3,1,221,242
YBR251W,17,3,2,257,274
YBR251W,27,3,3,815,842
YKL041W,101,2,1,309,410
YKL041W,36,2,2,476,512
YIR008C,21,8,1,329,350
YIR008C,26,8,2,513,539
YIR008C,35,8,3,657,692
YIR008C,40,8,4,750,790
YIR008C,33,8,5,778,811
YIR008C,21,8,6,1014,1035
YIR008C,22,8,7,1151,1173
YIR008C,23,8,8,1190,1213
YOR039W,87,1,1,593,680
YBL035C,41,4,1,850,891
YBL035C,30,4,2,1316,1346
YBL035C,47,4,3,1385,1432
YBL035C,88,4,4,1855,1943
YDR471W,26,3,1,174,200
YDR471W,44,3,2,217,261
YDR471W,51,3,3,326,377
YGR135W,44,1,1,529,573
YGL219C,37,4,1,362,399
YGL219C,37,4,2,656,693
YGL219C,39,4,3,1033,1072
YGL219C,15,4,4,1362,1377
YHR003C,27,6,1,545,572
YHR003C,82,6,2,582,664
YHR003C,20,6,3,816,836
YHR003C,17,6,4,1036,1053
YHR003C,15,6,5,1090,1105
YHR003C,24,6,6,1188,1212
YDR036C,19,11,1,189,208
YDR036C,20,11,2,217,237
YDR036C,24,11,3,293,317
YDR036C,25,11,4,331,356
YDR036C,47,11,5,389,436
YDR036C,24,11,6,523,547
YDR036C,52,11,7,1117,1169
YDR036C,30,11,8,1286,1316
YDR036C,27,11,9,1338,1365
YDR036C,24,11,10,1378,1402
YDR036C,23,11,11,1439,1462
YAL019W,16,7,1,754,770
YAL019W,22,7,2,1095,1117
YAL019W,25,7,3,1900,1925
YAL019W,20,7,4,1967,1987
YAL019W,17,7,5,2082,2099
YAL019W,45,7,6,2522,2567
YAL019W,20,7,7,3152,3172
YNR003C,38,3,1,487,525
YNR003C,59,3,2,526,585
YNR003C,38,3,3,910,948
YLR449W,25,2,1,625,650
YLR449W,29,2,2,1038,1067
YDR293C,20,5,1,2496,2516
YDR293C,31,5,2,2508,2539
YDR293C,15,5,3,3557,3572
YDR293C,22,5,4,3676,3698
YDR293C,15,5,5,3726,3741
YBR155W,38,1,1,578,616
YBL002W,15,1,1,377,392
YNR038W,45,2,1,633,678
YNR038W,23,2,2,687,710
YLR195C,30,4,1,531,561
YLR195C,16,4,2,564,580
YLR195C,37,4,3,707,744
YLR195C,28,4,4,1116,1144
YLR239C,36,4,1,254,290
YLR239C,25,4,2,356,381
YLR239C,27,4,3,624,651
YLR239C,23,4,4,735,758
YAL017W,41,11,1,558,599
YAL017W,31,11,2,593,624
YAL017W,21,11,3,1450,1471
YAL017W,25,11,4,1565,1590
YAL017W,19,11,5,1601,1620
YAL017W,26,11,6,2123,2149
YAL017W,20,11,7,2261,2281
YAL017W,24,11,8,2438,2462
YAL017W,18,11,9,2499,2517
YAL017W,16,11,10,2564,2580
YAL017W,17,11,11,2779,2796
YJR024C,45,3,1,386,431
YJR024C,23,3,2,516,539
YJR024C,28,3,3,690,718
YFL038C,50,5,1,179,229
YFL038C,18,5,2,302,320
YFL038C,28,5,3,420,448
YFL038C,17,5,4,458,475
YFL038C,87,5,5,495,582
YBR242W,18,3,1,302,320
YBR242W,55,3,2,417,472
YBR242W,62,3,3,550,612
YBR084W,50,3,1,301,351
YBR084W,37,3,2,381,418
YBR084W,66,3,3,434,500
YBR142W,18,2,1,929,947
YBR142W,20,2,2,1322,1342
YNR013C,30,2,1,261,291
YNR013C,15,2,2,1401,1416
YGR175C,417,6,1,204,621
YGR175C,67,6,2,629,696
YGR175C,29,6,3,697,726
YGR175C,15,6,4,771,786
YGR175C,138,6,5,975,1113
YGR175C,22,6,6,1469,1491
YIR017C,21,2,1,402,423
YIR017C,20,2,2,438,458
YKL047W,22,4,1,362,384
YKL047W,27,4,2,799,826
YKL047W,17,4,3,1085,1102
YKL047W,22,4,4,1173,1195
YIL128W,24,3,1,272,296
YIL128W,27,3,2,811,838
YIL128W,42,3,3,1572,1614
YJR137C,71,3,1,2885,2956
YJR137C,47,3,2,3623,3670
YJR137C,24,3,3,4305,4329
YNR012W,16,4,1,505,521
YNR012W,52,4,2,700,752
YNR012W,61,4,3,800,861
YNR012W,39,4,4,1062,1101
YGL097W,41,1,1,1285,1326
YKL087C,23,4,1,361,384
YKL087C,19,4,2,475,494
YKL087C,31,4,3,498,529
YKL087C,88,4,4,570,658
YNL076W,16,2,1,370,386
YNL076W,41,2,2,414,455
YDR367W,21,1,1,164,185
YHR072W,21,11,1,400,421
YHR072W,27,11,2,422,449
YHR072W,20,11,3,608,628
YHR072W,20,11,4,668,688
YHR072W,19,11,5,946,965
YHR072W,66,11,6,966,1032
YHR072W,29,11,7,1049,1078
YHR072W,34,11,8,1139,1173
YHR072W,29,11,9,1423,1452
YHR072W,47,11,10,1809,1856
YHR072W,18,11,11,1885,1903
YKL001C,38,1,1,440,478
YDR012W,253,2,1,343,596
YDR012W,59,2,2,1025,1084
YGL253W,22,4,1,418,440
YGL253W,53,4,2,685,738
YGL253W,54,4,3,951,1005
YGL253W,84,4,4,1297,1381
YAR002C-A,28,1,1,174,202
YOR271C,17,2,1,346,363
YOR271C,20,2,2,632,652
YNR041C,34,1,1,227,261
YOL030W,46,2,1,341,387
YOL030W,40,2,2,391,431
YML101C,15,1,1,164,179
YGR048W,37,3,1,291,328
YGR048W,23,3,2,635,658
YGR048W,21,3,3,659,680
YMR074C,21,1,1,207,228
YGR024C,29,4,1,199,228
YGR024C,32,4,2,438,470
YGR024C,93,4,3,474,567
YGR024C,46,4,4,569,615
YHR051W,47,4,1,162,209
YHR051W,58,4,2,243,301
YHR051W,28,4,3,370,398
YHR051W,22,4,4,400,422
YER154W,29,2,1,219,248
YER154W,26,2,2,885,911
YBR260C,30,4,1,361,391
YBR260C,29,4,2,694,723
YBR260C,45,4,3,1849,1894
YBR260C,21,4,4,1901,1922
YHR010W,40,3,1,173,213
YHR010W,37,3,2,223,260
YHR010W,33,3,3,329,362
YDR400W,79,6,1,514,593
YDR400W,45,6,2,594,639
YDR400W,25,6,3,661,686
YDR400W,29,6,4,683,712
YDR400W,21,6,5,732,753
YDR400W,21,6,6,755,776
YNL231C,19,7,1,425,444
YNL231C,136,7,2,573,709
YNL231C,58,7,3,713,771
YNL231C,34,7,4,789,823
YNL231C,61,7,5,831,892
YNL231C,55,7,6,883,938
YNL231C,64,7,7,939,1003
YAL042W,15,2,1,194,209
YAL042W,15,2,2,299,314
YLR056W,47,1,1,308,355
YLR304C,54,24,1,152,206
YLR304C,25,24,2,225,250
YLR304C,31,24,3,258,289
YLR304C,49,24,4,290,339
YLR304C,68,24,5,375,443
YLR304C,40,24,6,829,869
YLR304C,52,24,7,875,927
YLR304C,16,24,8,931,947
YLR304C,83,24,9,1051,1134
YLR304C,32,24,10,1295,1327
YLR304C,37,24,11,1358,1395
YLR304C,33,24,12,1397,1430
YLR304C,25,24,13,1432,1457
YLR304C,97,24,14,1466,1563
YLR304C,21,24,15,1629,1650
YLR304C,19,24,16,1668,1687
YLR304C,76,24,17,1692,1768
YLR304C,207,24,18,1791,1998
YLR304C,18,24,19,2013,2031
YLR304C,34,24,20,2053,2087
YLR304C,23,24,21,2088,2111
YLR304C,34,24,22,2125,2159
YLR304C,41,24,23,2146,2187
YLR304C,97,24,24,2208,2305
YOL041C,25,9,1,257,282
YOL041C,19,9,2,447,466
YOL041C,50,9,3,557,607
YOL041C,24,9,4,741,765
YOL041C,23,9,5,768,791
YOL041C,54,9,6,798,852
YOL041C,39,9,7,866,905
YOL041C,27,9,8,906,933
YOL041C,39,9,9,1097,1136
YFR038W,24,4,1,1058,1082
YFR038W,19,4,2,1087,1106
YFR038W,22,4,3,1233,1255
YFR038W,32,4,4,2084,2116
YNL286W,24,2,1,382,406
YNL286W,24,2,2,427,451
YDR001C,18,9,1,290,308
YDR001C,30,9,2,371,401
YDR001C,27,9,3,963,990
YDR001C,26,9,4,1183,1209
YDR001C,16,9,5,1221,1237
YDR001C,16,9,6,1373,1389
YDR001C,30,9,7,1593,1623
YDR001C,19,9,8,2079,2098
YDR001C,46,9,9,2108,2154
YIL162W,34,4,1,409,443
YIL162W,19,4,2,466,485
YIL162W,50,4,3,499,549
YIL162W,24,4,4,1469,1493
YOL141W,21,5,1,762,783
YOL141W,15,5,2,941,956
YOL141W,18,5,3,1286,1304
YOL141W,28,5,4,1665,1693
YOL141W,31,5,5,1948,1979
YGR080W,23,2,1,643,666
YGR080W,23,2,2,903,926
YOR037W,42,1,1,947,989
YBR195C,18,5,1,539,557
YBR195C,20,5,2,558,578
YBR195C,31,5,3,816,847
YBR195C,18,5,4,1218,1236
YBR195C,20,5,5,1238,1258
YDR138W,29,1,1,1501,1530
YOR317W,61,15,1,202,263
YOR317W,48,15,2,266,314
YOR317W,74,15,3,319,393
YOR317W,29,15,4,478,507
YOR317W,20,15,5,509,529
YOR317W,69,15,6,694,763
YOR317W,64,15,7,833,897
YOR317W,20,15,8,923,943
YOR317W,60,15,9,959,1019
YOR317W,18,15,10,1020,1038
YOR317W,150,15,11,1047,1197
YOR317W,18,15,12,1399,1417
YOR317W,70,15,13,1573,1643
YOR317W,36,15,14,1807,1843
YOR317W,32,15,15,1887,1919
YBR255C-A,22,1,1,308,330
YJR144W,16,1,1,455,471
YMR315W,38,6,1,239,277
YMR315W,46,6,2,382,428
YMR315W,37,6,3,517,554
YMR315W,330,6,4,566,896
YMR315W,20,6,5,903,923
YMR315W,88,6,6,937,1025
YLR328W,15,1,1,1190,1205
YLR039C,33,4,1,1227,1260
YLR039C,20,4,2,1650,1670
YLR039C,27,4,3,1914,1941
YLR039C,33,4,4,2705,2738
YML007W,15,4,1,658,673
YML007W,24,4,2,1016,1040
YML007W,45,4,3,1574,1619
YML007W,26,4,4,1913,1939
YER014W,45,2,1,223,268
YER014W,19,2,2,457,476
YPL115C,15,6,1,580,595
YPL115C,24,6,2,787,811
YPL115C,54,6,3,1680,1734
YPL115C,16,6,4,1864,1880
YPL115C,41,6,5,2168,2209
YPL115C,36,6,6,3135,3171
YGL057C,24,1,1,654,678
YOR185C,24,3,1,436,460
YOR185C,32,3,2,457,489
YOR185C,19,3,3,597,616
YOR244W,18,4,1,656,674
YOR244W,29,4,2,774,803
YOR244W,29,4,3,807,836
YOR244W,55,4,4,882,937
YDL046W,45,1,1,471,516
YDR503C,36,1,1,198,234
YGL037C,37,2,1,515,552
YGL037C,41,2,2,605,646
YBR058C,29,13,1,372,401
YBR058C,47,13,2,418,465
YBR058C,17,13,3,565,582
YBR058C,34,13,4,1010,1044
YBR058C,18,13,5,1248,1266
YBR058C,27,13,6,1299,1326
YBR058C,29,13,7,1551,1580
YBR058C,64,13,8,1631,1695
YBR058C,31,13,9,1715,1746
YBR058C,38,13,10,1774,1812
YBR058C,54,13,11,1925,1979
YBR058C,29,13,12,2215,2244
YBR058C,17,13,13,2304,2321
YLR048W,121,3,1,364,485
YLR048W,29,3,2,526,555
YLR048W,84,3,3,670,754
YDR492W,27,3,1,176,203
YDR492W,26,3,2,331,357
YDR492W,40,3,3,361,401
YLR071C,35,4,1,542,577
YLR071C,31,4,2,2451,2482
YLR071C,15,4,3,2504,2519
YLR071C,20,4,4,2759,2779
YGR240C,38,21,1,418,456
YGR240C,144,21,2,792,936
YGR240C,47,21,3,970,1017
YGR240C,53,21,4,1133,1186
YGR240C,23,21,5,1187,1210
YGR240C,46,21,6,1394,1440
YGR240C,36,21,7,1460,1496
YGR240C,21,21,8,1601,1622
YGR240C,40,21,9,1639,1679
YGR240C,37,21,10,1748,1785
YGR240C,54,21,11,1774,1828
YGR240C,30,21,12,1845,1875
YGR240C,25,21,13,2051,2076
YGR240C,29,21,14,2078,2107
YGR240C,21,21,15,2249,2270
YGR240C,21,21,16,2447,2468
YGR240C,18,21,17,2699,2717
YGR240C,17,21,18,2718,2735
YGR240C,75,21,19,2745,2820
YGR240C,54,21,20,2843,2897
YGR240C,19,21,21,2915,2934
YEL058W,111,13,1,148,259
YEL058W,15,13,2,288,303
YEL058W,67,13,3,294,361
YEL058W,16,13,4,389,405
YEL058W,24,13,5,459,483
YEL058W,20,13,6,516,536
YEL058W,21,13,7,629,650
YEL058W,28,13,8,659,687
YEL058W,64,13,9,773,837
YEL058W,39,13,10,1027,1066
YEL058W,16,13,11,1073,1089
YEL058W,18,13,12,1267,1285
YEL058W,24,13,13,1559,1583
YMR259C,47,18,1,166,213
YMR259C,35,18,2,218,253
YMR259C,26,18,3,643,669
YMR259C,37,18,4,851,888
YMR259C,21,18,5,908,929
YMR259C,27,18,6,1172,1199
YMR259C,56,18,7,1200,1256
YMR259C,19,18,8,1628,1647
YMR259C,37,18,9,2267,2304
YMR259C,51,18,10,2400,2451
YMR259C,34,18,11,2558,2592
YMR259C,35,18,12,2671,2706
YMR259C,42,18,13,2710,2752
YMR259C,28,18,14,3456,3484
YMR259C,19,18,15,3856,3875
YMR259C,22,18,16,3891,3913
YMR259C,20,18,17,3923,3943
YMR259C,23,18,18,3997,4020
YKL024C,52,1,1,277,329
YBR061C,34,4,1,293,327
YBR061C,22,4,2,367,389
YBR061C,26,4,3,592,618
YBR061C,67,4,4,669,736
YHL007C,33,5,1,1154,1187
YHL007C,29,5,2,1178,1207
YHL007C,19,5,3,1708,1727
YHL007C,36,5,4,2079,2115
YHL007C,27,5,5,2793,2820
YOR145C,53,1,1,536,589
YMR121C,54,4,1,199,253
YMR121C,48,4,2,275,323
YMR121C,29,4,3,330,359
YMR121C,16,4,4,378,394
YPR025C,29,5,1,379,408
YPR025C,21,5,2,471,492
YPR025C,15,5,3,560,575
YPR025C,22,5,4,851,873
YPR025C,15,5,5,1167,1182
YBR087W,22,2,1,365,387
YBR087W,74,2,2,957,1031
YDR330W,21,6,1,416,437
YDR330W,32,6,2,873,905
YDR330W,81,6,3,922,1003
YDR330W,66,6,4,1046,1112
YDR330W,41,6,5,1403,1444
YDR330W,28,6,6,1449,1477
YBL037W,20,3,1,288,308
YBL037W,26,3,2,1950,1976
YBL037W,16,3,3,2565,2581
YER114C,36,10,1,420,456
YER114C,18,10,2,1600,1618
YER114C,23,10,3,1699,1722
YER114C,21,10,4,2153,2174
YER114C,36,10,5,2537,2573
YER114C,62,10,6,2608,2670
YER114C,25,10,7,2673,2698
YER114C,29,10,8,2737,2766
YER114C,19,10,9,2887,2906
YER114C,20,10,10,3028,3048
YOR375C,60,4,1,458,518
YOR375C,32,4,2,505,537
YOR375C,43,4,3,704,747
YOR375C,21,4,4,1124,1145
YPR190C,29,1,1,1738,1767
YLR075W,15,2,1,254,269
YLR075W,72,2,2,538,610
YHR107C,29,4,1,572,601
YHR107C,20,4,2,613,633
YHR107C,33,4,3,702,735
YHR107C,55,4,4,911,966
YAR002W,76,10,1,273,349
YAR002W,17,10,2,810,827
YAR002W,39,10,3,836,875
YAR002W,15,10,4,1026,1041
YAR002W,17,10,5,1042,1059
YAR002W,44,10,6,1112,1156
YAR002W,26,10,7,1218,1244
YAR002W,17,10,8,1430,1447
YAR002W,40,10,9,1465,1505
YAR002W,30,10,10,1545,1575
YHR127W,17,3,1,271,288
YHR127W,26,3,2,523,549
YHR127W,20,3,3,706,726
YMR237W,46,9,1,433,479
YMR237W,30,9,2,599,629
YMR237W,24,9,3,1049,1073
YMR237W,29,9,4,1298,1327
YMR237W,60,9,5,1364,1424
YMR237W,16,9,6,1470,1486
YMR237W,68,9,7,1592,1660
YMR237W,31,9,8,1862,1893
YMR237W,28,9,9,1982,2010
YDL064W,57,1,1,415,472
YDL031W,27,3,1,978,1005
YDL031W,43,3,2,1132,1175
YDL031W,25,3,3,1459,1484
YDR514C,23,6,1,228,251
YDR514C,20,6,2,252,272
YDR514C,26,6,3,325,351
YDR514C,51,6,4,354,405
YDR514C,15,6,5,1364,1379
YDR514C,27,6,6,1386,1413
YEL029C,19,3,1,425,444
YEL029C,22,3,2,710,732
YEL029C,35,3,3,744,779
YMR228W,15,3,1,370,385
YMR228W,39,3,2,374,413
YMR228W,32,3,3,673,705
YMR125W,68,5,1,202,270
YMR125W,58,5,2,829,887
YMR125W,38,5,3,903,941
YMR125W,21,5,4,1567,1588
YMR125W,45,5,5,2414,2459
YMR092C,28,22,1,278,306
YMR092C,51,22,2,333,384
YMR092C,56,22,3,385,441
YMR092C,18,22,4,461,479
YMR092C,27,22,5,627,654
YMR092C,97,22,6,658,755
YMR092C,33,22,7,759,792
YMR092C,29,22,8,937,966
YMR092C,63,22,9,965,1028
YMR092C,37,22,10,1059,1096
YMR092C,30,22,11,1178,1208
YMR092C,70,22,12,1256,1326
YMR092C,21,22,13,1363,1384
YMR092C,15,22,14,1400,1415
YMR092C,40,22,15,1408,1448
YMR092C,16,22,16,1449,1465
YMR092C,15,22,17,1472,1487
YMR092C,17,22,18,1494,1511
YMR092C,21,22,19,1516,1537
YMR092C,38,22,20,1605,1643
YMR092C,39,22,21,1699,1738
YMR092C,25,22,22,1808,1833
YGL245W,71,7,1,817,888
YGL245W,34,7,2,979,1013
YGL245W,42,7,3,1151,1193
YGL245W,15,7,4,1469,1484
YGL245W,96,7,5,1646,1742
YGL245W,59,7,6,1757,1816
YGL245W,42,7,7,1964,2006
YER083C,21,1,1,579,600
YER070W,19,15,1,250,269
YER070W,70,15,2,1076,1146
YER070W,23,15,3,1150,1173
YER070W,35,15,4,1466,1501
YER070W,16,15,5,1561,1577
YER070W,52,15,6,1578,1630
YER070W,19,15,7,1647,1666
YER070W,25,15,8,1700,1725
YER070W,29,15,9,1932,1961
YER070W,16,15,10,1963,1979
YER070W,39,15,11,2038,2077
YER070W,45,15,12,2172,2217
YER070W,18,15,13,2487,2505
YER070W,34,15,14,2518,2552
YER070W,23,15,15,2555,2578
YPL262W,56,3,1,1193,1249
YPL262W,43,3,2,1318,1361
YPL262W,64,3,3,1396,1460
YGR079W,27,3,1,1022,1049
YGR079W,33,3,2,1050,1083
YGR079W,25,3,3,1087,1112
YDL119C,39,2,1,262,301
YDL119C,19,2,2,575,594
YNL068C,25,4,1,333,358
YNL068C,17,4,2,2175,2192
YNL068C,15,4,3,2202,2217
YNL068C,24,4,4,2280,2304
YGL129C,16,3,1,405,421
YGL129C,18,3,2,427,445
YGL129C,78,3,3,856,934
YPL020C,25,4,1,280,305
YPL020C,36,4,2,753,789
YPL020C,16,4,3,1108,1124
YPL020C,41,4,4,1569,1610
YKR057W,63,2,1,152,215
YKR057W,26,2,2,237,263
YKL151C,17,1,1,530,547
YMR028W,36,2,1,554,590
YMR028W,26,2,2,1014,1040
YGR222W,27,1,1,416,443
YDL086W,48,1,1,278,326
YCL040W,46,4,1,1082,1128
YCL040W,32,4,2,1215,1247
YCL040W,42,4,3,1310,1352
YCL040W,27,4,4,1370,1397
YBL091C-A,51,2,1,255,306
YBL091C-A,31,2,2,309,340
YOR163W,35,1,1,467,502
YMR044W,88,1,1,468,556
YJR065C,45,4,1,701,746
YJR065C,17,4,2,1037,1054
YJR065C,36,4,3,1041,1077
YJR065C,51,4,4,1151,1202
YKR093W,89,5,1,206,295
YKR093W,18,5,2,315,333
YKR093W,20,5,3,440,460
YKR093W,24,5,4,491,515
YKR093W,16,5,5,596,612
YNL308C,49,1,1,998,1047
YPL010W,42,1,1,360,402
YHR058C,27,1,1,824,851
YJR049C,25,7,1,605,630
YJR049C,31,7,2,701,732
YJR049C,23,7,3,889,912
YJR049C,93,7,4,933,1026
YJR049C,57,7,5,1179,1236
YJR049C,16,7,6,1370,1386
YJR049C,17,7,7,1387,1404
YPR112C,25,8,1,621,646
YPR112C,26,8,2,1007,1033
YPR112C,50,8,3,1317,1367
YPR112C,18,8,4,1719,1737
YPR112C,31,8,5,1724,1755
YPR112C,40,8,6,2183,2223
YPR112C,15,8,7,2520,2535
YPR112C,15,8,8,2538,2553
YGL010W,33,2,1,245,278
YGL010W,17,2,2,327,344
YML069W,41,7,1,257,298
YML069W,30,7,2,332,362
YML069W,39,7,3,704,743
YML069W,72,7,4,934,1006
YML069W,21,7,5,1008,1029
YML069W,66,7,6,1109,1175
YML069W,17,7,7,1361,1378
YPR169W,29,6,1,371,400
YPR169W,20,6,2,402,422
YPR169W,30,6,3,551,581
YPR169W,16,6,4,911,927
YPR169W,19,6,5,1203,1222
YPR169W,22,6,6,1271,1293
YLR175W,45,6,1,278,323
YLR175W,49,6,2,344,393
YLR175W,39,6,3,505,544
YLR175W,57,6,4,620,677
YLR175W,55,6,5,969,1024
YLR175W,48,6,6,1027,1075
YGR279C,15,2,1,224,239
YGR279C,58,2,2,912,970
YMR275C,16,5,1,1793,1809
YMR275C,21,5,2,2139,2160
YMR275C,27,5,3,2205,2232
YMR275C,24,5,4,2355,2379
YMR275C,28,5,5,2555,2583
YBL056W,17,4,1,582,599
YBL056W,33,4,2,865,898
YBL056W,103,4,3,1075,1178
YBL056W,48,4,4,1180,1228
YIL020C,67,5,1,261,328
YIL020C,21,5,2,333,354
YIL020C,43,5,3,515,558
YIL020C,106,5,4,563,669
YIL020C,22,5,5,747,769
YER052C,53,14,1,220,273
YER052C,21,14,2,299,320
YER052C,19,14,3,364,383
YER052C,20,14,4,410,430
YER052C,45,14,5,417,462
YER052C,20,14,6,619,639
YER052C,19,14,7,641,660
YER052C,16,14,8,666,682
YER052C,40,14,9,740,780
YER052C,24,14,10,843,867
YER052C,27,14,11,1042,1069
YER052C,26,14,12,1191,1217
YER052C,51,14,13,1218,1269
YER052C,54,14,14,1270,1324
YOL098C,20,7,1,190,210
YOL098C,38,7,2,1117,1155
YOL098C,21,7,3,1401,1422
YOL098C,24,7,4,1876,1900
YOL098C,32,7,5,2143,2175
YOL098C,27,7,6,2178,2205
YOL098C,57,7,7,2631,2688
YER003C,36,5,1,562,598
YER003C,15,5,2,786,801
YER003C,25,5,3,953,978
YER003C,72,5,4,1137,1209
YER003C,59,5,5,1224,1283
YDR173C,21,1,1,273,294
YCL057W,44,5,1,243,287
YCL057W,22,5,2,370,392
YCL057W,35,5,3,836,871
YCL057W,19,5,4,878,897
YCL057W,54,5,5,1544,1598
YBR005W,38,1,1,198,236
YPR063C,66,3,1,162,228
YPR063C,72,3,2,231,303
YPR063C,41,3,3,372,413
YGR231C,18,5,1,333,351
YGR231C,58,5,2,416,474
YGR231C,70,5,3,496,566
YGR231C,30,5,4,558,588
YGR231C,24,5,5,717,741
YEL063C,31,1,1,295,326
YBL076C,115,16,1,314,429
YBL076C,32,16,2,417,449
YBL076C,15,16,3,547,562
YBL076C,101,16,4,635,736
YBL076C,36,16,5,786,822
YBL076C,89,16,6,836,925
YBL076C,30,16,7,939,969
YBL076C,41,16,8,1122,1163
YBL076C,61,16,9,1366,1427
YBL076C,35,16,10,1454,1489
YBL076C,21,16,11,1570,1591
YBL076C,43,16,12,1639,1682
YBL076C,44,16,13,1982,2026
YBL076C,36,16,14,2783,2819
YBL076C,36,16,15,2895,2931
YBL076C,21,16,16,2977,2998
YMR113W,38,10,1,431,469
YMR113W,30,10,2,709,739
YMR113W,17,10,3,740,757
YMR113W,16,10,4,789,805
YMR113W,19,10,5,811,830
YMR113W,24,10,6,938,962
YMR113W,32,10,7,959,991
YMR113W,31,10,8,1045,1076
YMR113W,40,10,9,1140,1180
YMR113W,20,10,10,1200,1220
YPR097W,48,10,1,1019,1067
YPR097W,26,10,2,1563,1589
YPR097W,26,10,3,1901,1927
YPR097W,20,10,4,1929,1949
YPR097W,32,10,5,1988,2020
YPR097W,17,10,6,2153,2170
YPR097W,22,10,7,2210,2232
YPR097W,18,10,8,2235,2253
YPR097W,16,10,9,2261,2277
YPR097W,16,10,10,3138,3154
YDR454C,34,2,1,194,228
YDR454C,86,2,2,457,543
YKR068C,23,2,1,253,276
YKR068C,20,2,2,385,405
YML021C,61,1,1,464,525
YPR032W,15,9,1,1252,1267
YPR032W,16,9,2,1304,1320
YPR032W,31,9,3,1684,1715
YPR032W,15,9,4,1741,1756
YPR032W,29,9,5,1841,1870
YPR032W,34,9,6,2127,2161
YPR032W,20,9,7,2314,2334
YPR032W,32,9,8,2498,2530
YPR032W,24,9,9,2603,2627
YDL173W,28,2,1,208,236
YDL173W,16,2,2,583,599
YBR143C,153,4,1,360,513
YBR143C,39,4,2,703,742
YBR143C,26,4,3,759,785
YBR143C,35,4,4,875,910
YMR006C,26,3,1,374,400
YMR006C,19,3,2,401,420
YMR006C,60,3,3,408,468
YAL016W,20,6,1,530,550
YAL016W,32,6,2,671,703
YAL016W,32,6,3,993,1025
YAL016W,49,6,4,1073,1122
YAL016W,18,6,5,1175,1193
YAL016W,30,6,6,1874,1904
YFL039C,16,9,1,290,306
YFL039C,26,9,2,343,369
YFL039C,22,9,3,411,433
YFL039C,50,9,4,533,583
YFL039C,57,9,5,609,666
YFL039C,20,9,6,686,706
YFL039C,68,9,7,754,822
YFL039C,26,9,8,1076,1102
YFL039C,19,9,9,1103,1122
YDR449C,19,3,1,610,629
YDR449C,27,3,2,1102,1129
YDR449C,25,3,3,1193,1218
YLR367W,19,1,1,224,243
YKL080W,33,4,1,209,242
YKL080W,60,4,2,647,707
YKL080W,32,4,3,891,923
YKL080W,95,4,4,1002,1097
YPL152W,41,2,1,770,811
YPL152W,25,2,2,831,856
YIL052C,30,2,1,157,187
YIL052C,32,2,2,308,340
YNL021W,39,12,1,335,374
YNL021W,16,12,2,398,414
YNL021W,85,12,3,673,758
YNL021W,18,12,4,775,793
YNL021W,22,12,5,938,960
YNL021W,15,12,6,1250,1265
YNL021W,38,12,7,1267,1305
YNL021W,21,12,8,1468,1489
YNL021W,37,12,9,1509,1546
YNL021W,45,12,10,1547,1592
YNL021W,34,12,11,2010,2044
YNL021W,32,12,12,2046,2078
YKL186C,39,2,1,252,291
YKL186C,30,2,2,435,465
YGL123W,63,1,1,619,682
YNL077W,27,3,1,700,727
YNL077W,34,3,2,728,762
YNL077W,44,3,3,966,1010
YHR073W,24,6,1,223,247
YHR073W,28,6,2,346,374
YHR073W,16,6,3,494,510
YHR073W,27,6,4,544,571
YHR073W,18,6,5,1836,1854
YHR073W,22,6,6,2950,2972
YBR172C,29,3,1,1743,1772
YBR172C,17,3,2,1873,1890
YBR172C,18,3,3,1903,1921
YDR346C,53,13,1,204,257
YDR346C,37,13,2,261,298
YDR346C,16,13,3,299,315
YDR346C,19,13,4,575,594
YDR346C,20,13,5,706,726
YDR346C,27,13,6,727,754
YDR346C,35,13,7,944,979
YDR346C,42,13,8,983,1025
YDR346C,19,13,9,1094,1113
YDR346C,35,13,10,1106,1141
YDR346C,24,13,11,1206,1230
YDR346C,55,13,12,1326,1381
YDR346C,33,13,13,1386,1419
YJL172W,38,2,1,420,458
YJL172W,22,2,2,473,495
YDR151C,57,3,1,452,509
YDR151C,27,3,2,836,863
YDR151C,34,3,3,933,967
YNL222W,16,4,1,278,294
YNL222W,28,4,2,304,332
YNL222W,52,4,3,338,390
YNL222W,19,4,4,394,413
YPL086C,20,21,1,288,308
YPL086C,47,21,2,450,497
YPL086C,56,21,3,498,554
YPL086C,98,21,4,555,653
YPL086C,16,21,5,654,670
YPL086C,47,21,6,657,704
YPL086C,22,21,7,740,762
YPL086C,44,21,8,759,803
YPL086C,34,21,9,832,866
YPL086C,30,21,10,876,906
YPL086C,21,21,11,924,945
YPL086C,32,21,12,994,1026
YPL086C,24,21,13,1031,1055
YPL086C,31,21,14,1166,1197
YPL086C,22,21,15,1205,1227
YPL086C,21,21,16,1242,1263
YPL086C,70,21,17,1346,1416
YPL086C,49,21,18,1427,1476
YPL086C,18,21,19,1481,1499
YPL086C,31,21,20,1500,1531
YPL086C,18,21,21,1641,1659
YKR042W,83,4,1,226,309
YKR042W,17,4,2,315,332
YKR042W,54,4,3,601,655
YKR042W,49,4,4,812,861
YPL090C,60,3,1,201,261
YPL090C,85,3,2,331,416
YPL090C,19,3,3,641,660
YHR146W,38,4,1,211,249
YHR146W,58,4,2,262,320
YHR146W,38,4,3,548,586
YHR146W,37,4,4,1021,1058
YDL142C,23,1,1,685,708
YHR198C,33,2,1,627,660
YHR198C,15,2,2,669,684
YGL196W,41,2,1,953,994
YGL196W,15,2,2,1262,1277
YKL126W,36,10,1,338,374
YKL126W,42,10,2,517,559
YKL126W,28,10,3,646,674
YKL126W,60,10,4,1047,1107
YKL126W,49,10,5,1260,1309
YKL126W,42,10,6,1348,1390
YKL126W,33,10,7,1476,1509
YKL126W,20,10,8,1622,1642
YKL126W,59,10,9,1702,1761
YKL126W,19,10,10,1910,1929
YLR209C,15,3,1,410,425
YLR209C,25,3,2,426,451
YLR209C,21,3,3,907,928
YHR158C,49,10,1,390,439
YHR158C,48,10,2,444,492
YHR158C,41,10,3,532,573
YHR158C,15,10,4,660,675
YHR158C,63,10,5,870,933
YHR158C,23,10,6,941,964
YHR158C,27,10,7,2219,2246
YHR158C,18,10,8,2298,2316
YHR158C,42,10,9,2344,2386
YHR158C,40,10,10,2774,2814
YDR264C,18,1,1,1064,1082
YKL039W,46,1,1,152,198
YNL035C,35,9,1,196,231
YNL035C,38,9,2,244,282
YNL035C,21,9,3,283,304
YNL035C,25,9,4,386,411
YNL035C,36,9,5,535,571
YNL035C,66,9,6,579,645
YNL035C,34,9,7,683,717
YNL035C,33,9,8,722,755
YNL035C,50,9,9,1064,1114
YLR287C,28,3,1,212,240
YLR287C,21,3,2,719,740
YLR287C,26,3,3,865,891
YPL016W,72,3,1,2416,2488
YPL016W,22,3,2,2581,2603
YPL016W,35,3,3,3848,3883
YPL061W,58,10,1,173,231
YPL061W,56,10,2,400,456
YPL061W,56,10,3,624,680
YPL061W,16,10,4,710,726
YPL061W,39,10,5,731,770
YPL061W,26,10,6,907,933
YPL061W,52,10,7,1174,1226
YPL061W,92,10,8,1257,1349
YPL061W,63,10,9,1354,1417
YPL061W,77,10,10,1422,1499
YNL177C,30,2,1,647,677
YNL177C,19,2,2,700,719
YLR387C,76,1,1,900,976
YLR250W,22,1,1,295,317
YKL122C,231,2,1,167,398
YKL122C,103,2,2,401,504
YAL043C,53,4,1,247,300
YAL043C,33,4,2,294,327
YAL043C,52,4,3,510,562
YAL043C,23,4,4,2260,2283
YOL093W,38,2,1,544,582
YOL093W,31,2,2,583,614
YBL058W,80,4,1,827,907
YBL058W,38,4,2,894,932
YBL058W,27,4,3,999,1026
YBL058W,87,4,4,1182,1269
YBR236C,32,3,1,1009,1041
YBR236C,32,3,2,1160,1192
YBR236C,17,3,3,1193,1210
YPL125W,24,10,1,569,593
YPL125W,89,10,2,627,716
YPL125W,29,10,3,951,980
YPL125W,37,10,4,1126,1163
YPL125W,32,10,5,1299,1331
YPL125W,17,10,6,1372,1389
YPL125W,15,10,7,1411,1426
YPL125W,31,10,8,1438,1469
YPL125W,41,10,9,1886,1927
YPL125W,21,10,10,2163,2184
YIL070C,33,1,1,273,306
YCL037C,66,2,1,904,970
YCL037C,33,2,2,1213,1246
YIL009W,18,9,1,230,248
YIL009W,27,9,2,413,440
YIL009W,21,9,3,731,752
YIL009W,36,9,4,1275,1311
YIL009W,25,9,5,1759,1784
YIL009W,33,9,6,1889,1922
YIL009W,68,9,7,1934,2002
YIL009W,26,9,8,2004,2030
YIL009W,16,9,9,2034,2050
YHR076W,23,2,1,615,638
YHR076W,38,2,2,682,720
YOR063W,33,3,1,242,275
YOR063W,28,3,2,352,380
YOR063W,130,3,3,391,521
YOL140W,33,8,1,203,236
YOL140W,28,8,2,265,293
YOL140W,16,8,3,347,363
YOL140W,16,8,4,367,383
YOL140W,16,8,5,564,580
YOL140W,23,8,6,633,656
YOL140W,30,8,7,706,736
YOL140W,20,8,8,1199,1219
YGL223C,19,2,1,440,459
YGL223C,42,2,2,941,983
YOR036W,24,1,1,346,370
YJR090C,39,4,1,1051,1090
YJR090C,27,4,2,1425,1452
YJR090C,17,4,3,2386,2403
YJR090C,16,4,4,2996,3012
YML131W,44,2,1,662,706
YML131W,30,2,2,710,740
YGL150C,18,9,1,318,336
YGL150C,30,9,2,1298,1328
YGL150C,31,9,3,2250,2281
YGL150C,23,9,4,2286,2309
YGL150C,30,9,5,2576,2606
YGL150C,22,9,6,2614,2636
YGL150C,21,9,7,2858,2879
YGL150C,16,9,8,4021,4037
YGL150C,42,9,9,4413,4455
YGL040C,44,3,1,339,383
YGL040C,36,3,2,480,516
YGL040C,18,3,3,531,549
YJR145C,20,2,1,323,343
YJR145C,25,2,2,536,561
YNL292W,26,4,1,671,697
YNL292W,31,4,2,698,729
YNL292W,35,4,3,1036,1071
YNL292W,15,4,4,1107,1122
YLR305C,25,14,1,180,205
YLR305C,39,14,2,539,578
YLR305C,35,14,3,692,727
YLR305C,27,14,4,2249,2276
YLR305C,27,14,5,2971,2998
YLR305C,17,14,6,3007,3024
YLR305C,25,14,7,3026,3051
YLR305C,36,14,8,3362,3398
YLR305C,29,14,9,3778,3807
YLR305C,29,14,10,4385,4414
YLR305C,18,14,11,4800,4818
YLR305C,31,14,12,5001,5032
YLR305C,15,14,13,5376,5391
YLR305C,31,14,14,5582,5613
YNL197C,18,3,1,473,491
YNL197C,58,3,2,1271,1329
YNL197C,17,3,3,1334,1351
YOR354C,15,13,1,209,224
YOR354C,27,13,2,267,294
YOR354C,30,13,3,376,406
YOR354C,23,13,4,583,606
YOR354C,19,13,5,642,661
YOR354C,27,13,6,662,689
YOR354C,27,13,7,907,934
YOR354C,17,13,8,1039,1056
YOR354C,30,13,9,1044,1074
YOR354C,18,13,10,1078,1096
YOR354C,19,13,11,1577,1596
YOR354C,22,13,12,1634,1656
YOR354C,27,13,13,2030,2057
YIL038C,16,6,1,1358,1374
YIL038C,42,6,2,1672,1714
YIL038C,50,6,3,2164,2214
YIL038C,21,6,4,2220,2241
YIL038C,37,6,5,2264,2301
YIL038C,46,6,6,2363,2409
YNR009W,29,2,1,352,381
YNR009W,17,2,2,445,462
YNL148C,21,1,1,218,239
YLR439W,21,4,1,174,195
YLR439W,55,4,2,401,456
YLR439W,38,4,3,463,501
YLR439W,30,4,4,502,532
YIL143C,32,11,1,654,686
YIL143C,25,11,2,902,927
YIL143C,52,11,3,1203,1255
YIL143C,38,11,4,1266,1304
YIL143C,46,11,5,1307,1353
YIL143C,16,11,6,1360,1376
YIL143C,16,11,7,1377,1393
YIL143C,31,11,8,1400,1431
YIL143C,24,11,9,1560,1584
YIL143C,22,11,10,1597,1619
YIL143C,18,11,11,1659,1677
YGR092W,27,8,1,304,331
YGR092W,20,8,2,743,763
YGR092W,21,8,3,764,785
YGR092W,43,8,4,849,892
YGR092W,62,8,5,936,998
YGR092W,26,8,6,1046,1072
YGR092W,22,8,7,1451,1473
YGR092W,36,8,8,1574,1610
YBR256C,18,3,1,415,433
YBR256C,21,3,2,491,512
YBR256C,22,3,3,660,682
YDR328C,25,1,1,549,574
YLR247C,24,7,1,962,986
YLR247C,22,7,2,1484,1506
YLR247C,21,7,3,1922,1943
YLR247C,30,7,4,2096,2126
YLR247C,18,7,5,2243,2261
YLR247C,26,7,6,2262,2288
YLR247C,54,7,7,2484,2538
YBL016W,47,4,1,257,304
YBL016W,17,4,2,800,817
YBL016W,19,4,3,871,890
YBL016W,16,4,4,891,907
YOR014W,21,5,1,1118,1139
YOR014W,23,5,2,1162,1185
YOR014W,47,5,3,1593,1640
YOR014W,33,5,4,1904,1937
YOR014W,25,5,5,2154,2179
YOR057W,24,6,1,451,475
YOR057W,24,6,2,602,626
YOR057W,51,6,3,710,761
YOR057W,27,6,4,791,818
YOR057W,18,6,5,878,896
YOR057W,28,6,6,900,928
YDR513W,52,1,1,324,376
YOR362C,105,7,1,203,308
YOR362C,22,7,2,309,331
YOR362C,53,7,3,346,399
YOR362C,34,7,4,419,453
YOR362C,109,7,5,509,618
YOR362C,63,7,6,632,695
YOR362C,41,7,7,736,777
YLR448W,18,1,1,224,242
YGR103W,34,2,1,713,747
YGR103W,56,2,2,1447,1503
YDR311W,18,2,1,377,395
YDR311W,18,2,2,814,832
YIL041W,31,1,1,364,395
YGR178C,24,2,1,683,707
YGR178C,32,2,2,1651,1683
YNL155W,24,1,1,277,301
YNL100W,18,3,1,284,302
YNL100W,43,3,2,303,346
YNL100W,15,3,3,690,705
YLR078C,19,1,1,311,330
YBR154C,20,2,1,201,221
YBR154C,26,2,2,485,511
YBR216C,37,13,1,815,852
YBR216C,19,13,2,997,1016
YBR216C,36,13,3,1004,1040
YBR216C,51,13,4,1074,1125
YBR216C,23,13,5,1345,1368
YBR216C,31,13,6,1419,1450
YBR216C,33,13,7,1452,1485
YBR216C,17,13,8,1623,1640
YBR216C,42,13,9,1628,1670
YBR216C,37,13,10,1772,1809
YBR216C,18,13,11,1828,1846
YBR216C,26,13,12,1849,1875
YBR216C,17,13,13,1894,1911
YNL245C,21,1,1,206,227
YMR318C,53,9,1,363,416
YMR318C,132,9,2,469,601
YMR318C,26,9,3,663,689
YMR318C,25,9,4,752,777
YMR318C,17,9,5,779,796
YMR318C,17,9,6,898,915
YMR318C,15,9,7,951,966
YMR318C,92,9,8,969,1061
YMR318C,16,9,9,1067,1083
YCR009C,78,1,1,709,787
YGR085C,102,1,1,351,453
YLR109W,17,2,1,361,378
YLR109W,36,2,2,410,446
YDR025W,24,2,1,332,356
YDR025W,42,2,2,395,437
YAR003W,61,1,1,405,466
YBL030C,40,3,1,277,317
YBL030C,39,3,2,741,780
YBL030C,30,3,3,788,818
YER148W,22,3,1,400,422
YER148W,18,3,2,458,476
YER148W,51,3,3,620,671
YGL242C,49,2,1,405,454
YGL242C,35,2,2,488,523
YHL015W,57,2,1,217,274
YHL015W,87,2,2,278,365
YOR303W,36,4,1,575,611
YOR303W,28,4,2,628,656
YOR303W,21,4,3,839,860
YOR303W,29,4,4,1061,1090
YMR192W,21,5,1,1318,1339
YMR192W,32,5,2,1331,1363
YMR192W,24,5,3,1487,1511
YMR192W,77,5,4,1512,1589
YMR192W,28,5,5,1794,1822
YGR078C,65,3,1,294,359
YGR078C,38,3,2,364,402
YGR078C,33,3,3,498,531
YER073W,47,5,1,198,245
YER073W,40,5,2,454,494
YER073W,37,5,3,685,722
YER073W,44,5,4,753,797
YER073W,124,5,5,1290,1414
YMR229C,50,11,1,921,971
YMR229C,28,11,2,1602,1630
YMR229C,58,11,3,1845,1903
YMR229C,43,11,4,2339,2382
YMR229C,48,11,5,2654,2702
YMR229C,19,11,6,2997,3016
YMR229C,68,11,7,3605,3673
YMR229C,18,11,8,3778,3796
YMR229C,36,11,9,3947,3983
YMR229C,62,11,10,4071,4133
YMR229C,32,11,11,4988,5020
YKR062W,43,2,1,422,465
YKR062W,40,2,2,766,806
YBR046C,15,7,1,146,161
YBR046C,38,7,2,335,373
YBR046C,27,7,3,369,396
YBR046C,31,7,4,498,529
YBR046C,17,7,5,661,678
YBR046C,16,7,6,803,819
YBR046C,67,7,7,933,1000
YOL124C,43,1,1,1259,1302
YDR013W,26,1,1,404,430
YNR040W,27,2,1,460,487
YNR040W,29,2,2,484,513
YHL033C,136,4,1,263,399
YHL033C,60,4,2,401,461
YHL033C,83,4,3,518,601
YHL033C,43,4,4,675,718
YOR270C,79,7,1,180,259
YOR270C,177,7,2,260,437
YOR270C,30,7,3,719,749
YOR270C,36,7,4,807,843
YOR270C,32,7,5,830,862
YOR270C,26,7,6,892,918
YOR270C,39,7,7,971,1010
YHR020W,47,13,1,198,245
YHR020W,18,13,2,248,266
YHR020W,28,13,3,305,333
YHR020W,29,13,4,335,364
YHR020W,42,13,5,403,445
YHR020W,156,13,6,988,1144
YHR020W,24,13,7,1259,1283
YHR020W,45,13,8,1500,1545
YHR020W,24,13,9,1706,1730
YHR020W,15,13,10,1793,1808
YHR020W,30,13,11,1800,1830
YHR020W,20,13,12,1831,1851
YHR020W,21,13,13,2028,2049
YGL252C,17,15,1,229,246
YGL252C,41,15,2,235,276
YGL252C,69,15,3,411,480
YGL252C,55,15,4,566,621
YGL252C,43,15,5,726,769
YGL252C,17,15,6,933,950
YGL252C,62,15,7,937,999
YGL252C,15,15,8,1002,1017
YGL252C,15,15,9,1044,1059
YGL252C,28,15,10,1185,1213
YGL252C,35,15,11,1414,1449
YGL252C,37,15,12,1494,1531
YGL252C,45,15,13,1532,1577
YGL252C,30,15,14,1664,1694
YGL252C,44,15,15,1723,1767
YLL043W,62,3,1,385,447
YLL043W,76,3,2,759,835
YLL043W,51,3,3,822,873
YPR051W,35,2,1,205,240
YPR051W,67,2,2,334,401
YIR026C,21,3,1,215,236
YIR026C,56,3,2,806,862
YIR026C,28,3,3,872,900
YOL133W,18,2,1,241,259
YOL133W,50,2,2,313,363
YML100W,30,7,1,515,545
YML100W,19,7,2,557,576
YML100W,21,7,3,1168,1189
YML100W,19,7,4,1209,1228
YML100W,19,7,5,1396,1415
YML100W,35,7,6,1420,1455
YML100W,30,7,7,3141,3171
YPL001W,27,3,1,222,249
YPL001W,35,3,2,288,323
YPL001W,27,3,3,908,935
YPL043W,16,10,1,316,332
YPL043W,24,10,2,333,357
YPL043W,37,10,3,382,419
YPL043W,85,10,4,608,693
YPL043W,32,10,5,1478,1510
YPL043W,35,10,6,1537,1572
YPL043W,18,10,7,1643,1661
YPL043W,45,10,8,1673,1718
YPL043W,28,10,9,1880,1908
YPL043W,33,10,10,1898,1931
YLR410W,17,13,1,348,365
YLR410W,132,13,2,884,1016
YLR410W,77,13,3,1041,1118
YLR410W,92,13,4,1179,1271
YLR410W,76,13,5,1280,1356
YLR410W,36,13,6,1707,1743
YLR410W,25,13,7,1913,1938
YLR410W,43,13,8,2346,2389
YLR410W,37,13,9,2936,2973
YLR410W,36,13,10,3074,3110
YLR410W,32,13,11,3243,3275
YLR410W,34,13,12,3328,3362
YLR410W,19,13,13,3376,3395
YER004W,87,3,1,212,299
YER004W,29,3,2,300,329
YER004W,62,3,3,531,593
YBR039W,43,4,1,217,260
YBR039W,66,4,2,263,329
YBR039W,35,4,3,533,568
YBR039W,15,4,4,619,634
YCR072C,16,17,1,200,216
YCR072C,26,17,2,217,243
YCR072C,46,17,3,246,292
YCR072C,40,17,4,359,399
YCR072C,39,17,5,402,441
YCR072C,40,17,6,452,492
YCR072C,17,17,7,524,541
YCR072C,22,17,8,701,723
YCR072C,31,17,9,710,741
YCR072C,60,17,10,743,803
YCR072C,25,17,11,853,878
YCR072C,18,17,12,908,926
YCR072C,17,17,13,984,1001
YCR072C,26,17,14,1241,1267
YCR072C,18,17,15,1317,1335
YCR072C,15,17,16,1338,1353
YCR072C,37,17,17,1406,1443
YKR016W,22,3,1,982,1004
YKR016W,60,3,2,1305,1365
YKR016W,30,3,3,1379,1409
YMR158W,42,3,1,196,238
YMR158W,20,3,2,390,410
YMR158W,28,3,3,421,449
YLR114C,32,2,1,782,814
YLR114C,15,2,2,1353,1368
YMR203W,16,1,1,1109,1125
YLL036C,52,11,1,350,402
YLL036C,39,11,2,471,510
YLL036C,36,11,3,634,670
YLL036C,36,11,4,737,773
YLL036C,17,11,5,805,822
YLL036C,22,11,6,824,846
YLL036C,36,11,7,834,870
YLL036C,19,11,8,875,894
YLL036C,29,11,9,905,934
YLL036C,45,11,10,1249,1294
YLL036C,31,11,11,1464,1495
YJL024C,60,3,1,159,219
YJL024C,42,3,2,284,326
YJL024C,51,3,3,357,408
YDL029W,43,10,1,232,275
YDL029W,30,10,2,278,308
YDL029W,35,10,3,315,350
YDL029W,22,10,4,355,377
YDL029W,24,10,5,483,507
YDL029W,28,10,6,528,556
YDL029W,37,10,7,545,582
YDL029W,68,10,8,738,806
YDL029W,56,10,9,994,1050
YDL029W,50,10,10,1037,1087
YER102W,32,1,1,296,328
YBL057C,15,1,1,591,606
YBR073W,60,9,1,326,386
YBR073W,23,9,2,1122,1145
YBR073W,70,9,3,1887,1957
YBR073W,43,9,4,1986,2029
YBR073W,25,9,5,2045,2070
YBR073W,16,9,6,2216,2232
YBR073W,20,9,7,2655,2675
YBR073W,38,9,8,2758,2796
YBR073W,17,9,9,2838,2855
YPL004C,121,2,1,488,609
YPL004C,50,2,2,915,965
YER019W,33,3,1,764,797
YER019W,37,3,2,913,950
YER019W,15,3,3,1200,1215
YPR176C,42,1,1,456,498
YMR263W,33,2,1,477,510
YMR263W,33,2,2,497,530
YDR172W,125,4,1,1763,1888
YDR172W,22,4,2,1889,1911
YDR172W,31,4,3,1912,1943
YDR172W,26,4,4,1962,1988
YPR033C,81,2,1,507,588
YPR033C,17,2,2,1537,1554
YBR211C,25,1,1,521,546
YLR129W,31,16,1,564,595
YLR129W,22,16,2,596,618
YLR129W,63,16,3,679,742
YLR129W,20,16,4,836,856
YLR129W,32,16,5,1213,1245
YLR129W,73,16,6,1642,1715
YLR129W,18,16,7,1736,1754
YLR129W,15,16,8,1830,1845
YLR129W,23,16,9,1940,1963
YLR129W,29,16,10,2055,2084
YLR129W,88,16,11,2141,2229
YLR129W,36,16,12,2234,2270
YLR129W,25,16,13,2272,2297
YLR129W,21,16,14,2446,2467
YLR129W,22,16,15,2597,2619
YLR129W,34,16,16,2627,2661
YBL079W,27,13,1,668,695
YBL079W,20,13,2,697,717
YBL079W,20,13,3,1258,1278
YBL079W,47,13,4,1350,1397
YBL079W,37,13,5,1445,1482
YBL079W,27,13,6,1880,1907
YBL079W,72,13,7,1957,2029
YBL079W,27,13,8,2081,2108
YBL079W,18,13,9,2272,2290
YBL079W,43,13,10,2328,2371
YBL079W,23,13,11,2374,2397
YBL079W,23,13,12,2506,2529
YBL079W,30,13,13,2618,2648
YPR120C,43,1,1,410,453
YBL041W,92,3,1,393,485
YBL041W,47,3,2,635,682
YBL041W,30,3,3,689,719
YLL022C,26,2,1,261,287
YLL022C,38,2,2,991,1029
YDR528W,26,2,1,818,844
YDR528W,16,2,2,864,880
YDL058W,24,11,1,366,390
YDL058W,31,11,2,577,608
YDL058W,27,11,3,614,641
YDL058W,18,11,4,953,971
YDL058W,61,11,5,1153,1214
YDL058W,22,11,6,1312,1334
YDL058W,15,11,7,1345,1360
YDL058W,107,11,8,1352,1459
YDL058W,18,11,9,1715,1733
YDL058W,16,11,10,1850,1866
YDL058W,16,11,11,1975,1991
YLR150W,30,2,1,326,356
YLR150W,15,2,2,740,755
YBR026C,92,11,1,237,329
YBR026C,28,11,2,341,369
YBR026C,40,11,3,424,464
YBR026C,25,11,4,473,498
YBR026C,55,11,5,500,555
YBR026C,15,11,6,564,579
YBR026C,60,11,7,630,690
YBR026C,83,11,8,727,810
YBR026C,68,11,9,884,952
YBR026C,126,11,10,954,1080
YBR026C,62,11,11,1081,1143
YDL185W,33,13,1,226,259
YDL185W,28,13,2,686,714
YDL185W,57,13,3,1121,1178
YDL185W,133,13,4,1635,1768
YDL185W,72,13,5,1790,1862
YDL185W,25,13,6,1991,2016
YDL185W,41,13,7,2010,2051
YDL185W,43,13,8,2221,2264
YDL185W,29,13,9,2464,2493
YDL185W,50,13,10,2516,2566
YDL185W,15,13,11,2567,2582
YDL185W,29,13,12,2585,2614
YDL185W,95,13,13,2662,2757
YLR403W,17,1,1,1358,1375
YPR180W,29,4,1,654,683
YPR180W,43,4,2,718,761
YPR180W,19,4,3,860,879
YPR180W,15,4,4,884,899
YEL013W,40,9,1,850,890
YEL013W,25,9,2,1019,1044
YEL013W,28,9,3,1064,1092
YEL013W,75,9,4,1098,1173
YEL013W,15,9,5,1211,1226
YEL013W,28,9,6,1249,1277
YEL013W,16,9,7,1454,1470
YEL013W,33,9,8,1487,1520
YEL013W,35,9,9,1538,1573
YDL007W,73,7,1,283,356
YDL007W,41,7,2,367,408
YDL007W,100,7,3,769,869
YDL007W,56,7,4,870,926
YDL007W,27,7,5,929,956
YDL007W,25,7,6,1145,1170
YDL007W,62,7,7,1249,1311
YGL056C,16,1,1,688,704
YDR385W,56,18,1,335,391
YDR385W,41,18,2,402,443
YDR385W,25,18,3,482,507
YDR385W,44,18,4,571,615
YDR385W,61,18,5,1073,1134
YDR385W,27,18,6,1174,1201
YDR385W,97,18,7,1232,1329
YDR385W,52,18,8,1573,1625
YDR385W,34,18,9,1663,1697
YDR385W,36,18,10,1975,2011
YDR385W,85,18,11,2015,2100
YDR385W,37,18,12,2114,2151
YDR385W,39,18,13,2189,2228
YDR385W,38,18,14,2233,2271
YDR385W,19,18,15,2282,2301
YDR385W,44,18,16,2429,2473
YDR385W,20,18,17,2477,2497
YDR385W,30,18,18,2495,2525
YOR280C,97,2,1,268,365
YOR280C,43,2,2,354,397
YML004C,87,4,1,222,309
YML004C,28,4,2,317,345
YML004C,18,4,3,702,720
YML004C,39,4,4,708,747
YMR210W,27,1,1,387,414
YMR024W,17,1,1,255,272
YBR059C,49,1,1,274,323
YPR024W,20,5,1,291,311
YPR024W,16,5,2,822,838
YPR024W,32,5,3,825,857
YPR024W,29,5,4,1546,1575
YPR024W,43,5,5,1882,1925
YDL045C,21,1,1,328,349
YGR241C,57,1,1,335,392
YMR258C,17,3,1,459,476
YMR258C,34,3,2,650,684
YMR258C,37,3,3,722,759
YDL198C,91,4,1,297,388
YDL198C,16,4,2,389,405
YDL198C,40,4,3,407,447
YDL198C,16,4,4,482,498
YDR103W,58,10,1,1218,1276
YDR103W,36,10,2,1289,1325
YDR103W,17,10,3,1449,1466
YDR103W,32,10,4,1559,1591
YDR103W,51,10,5,1948,1999
YDR103W,42,10,6,2288,2330
YDR103W,19,10,7,2342,2361
YDR103W,25,10,8,2440,2465
YDR103W,25,10,9,2618,2643
YDR103W,22,10,10,2697,2719
YLR072W,16,12,1,201,217
YLR072W,25,12,2,534,559
YLR072W,50,12,3,665,715
YLR072W,17,12,4,859,876
YLR072W,46,12,5,1220,1266
YLR072W,22,12,6,1274,1296
YLR072W,25,12,7,1328,1353
YLR072W,20,12,8,1361,1381
YLR072W,15,12,9,1654,1669
YLR072W,28,12,10,1799,1827
YLR072W,43,12,11,1815,1858
YLR072W,25,12,12,1959,1984
YPL159C,25,6,1,156,181
YPL159C,19,6,2,185,204
YPL159C,133,6,3,207,340
YPL159C,16,6,4,497,513
YPL159C,29,6,5,548,577
YPL159C,38,6,6,703,741
YOR181W,49,5,1,225,274
YOR181W,47,5,2,284,331
YOR181W,16,5,3,344,360
YOR181W,29,5,4,539,568
YOR181W,19,5,5,1152,1171
YDL092W,62,3,1,209,271
YDL092W,42,3,2,272,314
YDL092W,61,3,3,323,384
YKR043C,117,5,1,344,461
YKR043C,24,5,2,656,680
YKR043C,31,5,3,688,719
YKR043C,25,5,4,734,759
YKR043C,21,5,5,765,786
YPL084W,25,8,1,490,515
YPL084W,38,8,2,505,543
YPL084W,61,8,3,851,912
YPL084W,31,8,4,1270,1301
YPL084W,17,8,5,1512,1529
YPL084W,53,8,6,1636,1689
YPL084W,40,8,7,1797,1837
YPL084W,17,8,8,1853,1870
YLR166C,40,2,1,691,731
YLR166C,37,2,2,1018,1055
YMR067C,30,1,1,418,448
YDL143W,26,6,1,585,611
YDL143W,37,6,2,1124,1161
YDL143W,24,6,3,1219,1243
YDL143W,76,6,4,1247,1323
YDL143W,22,6,5,1358,1380
YDL143W,36,6,6,1416,1452
YDL161W,105,4,1,181,286
YDL161W,61,4,2,370,431
YDL161W,46,4,3,512,558
YDL161W,29,4,4,1101,1130
YNL056W,52,2,1,199,251
YNL056W,71,2,2,293,364
YPL093W,45,13,1,264,309
YPL093W,66,13,2,684,750
YPL093W,28,13,3,867,895
YPL093W,89,13,4,901,990
YPL093W,53,13,5,1008,1061
YPL093W,77,13,6,1166,1243
YPL093W,20,13,7,1302,1322
YPL093W,20,13,8,1384,1404
YPL093W,87,13,9,1436,1523
YPL093W,45,13,10,1632,1677
YPL093W,37,13,11,1687,1724
YPL093W,62,13,12,1728,1790
YPL093W,46,13,13,1891,1937
YDR347W,37,2,1,695,732
YDR347W,40,2,2,843,883
YFL001W,16,3,1,745,761
YFL001W,15,3,2,769,784
YFL001W,32,3,3,909,941
YER086W,20,12,1,236,256
YER086W,41,12,2,266,307
YER086W,47,12,3,330,377
YER086W,29,12,4,432,461
YER086W,34,12,5,448,482
YER086W,22,12,6,587,609
YER086W,115,12,7,644,759
YER086W,15,12,8,871,886
YER086W,18,12,9,887,905
YER086W,39,12,10,915,954
YER086W,38,12,11,959,997
YER086W,22,12,12,1105,1127
YKL078W,39,11,1,538,577
YKL078W,59,11,2,620,679
YKL078W,19,11,3,894,913
YKL078W,26,11,4,915,941
YKL078W,25,11,5,962,987
YKL078W,22,11,6,1059,1081
YKL078W,26,11,7,1208,1234
YKL078W,22,11,8,1279,1301
YKL078W,16,11,9,1587,1603
YKL078W,18,11,10,1902,1920
YKL078W,28,11,11,1966,1994
YDR207C,16,5,1,275,291
YDR207C,48,5,2,1347,1395
YDR207C,26,5,3,1860,1886
YDR207C,18,5,4,1962,1980
YDR207C,18,5,5,2325,2343
YNL132W,60,17,1,760,820
YNL132W,26,17,2,1192,1218
YNL132W,79,17,3,1453,1532
YNL132W,35,17,4,1555,1590
YNL132W,20,17,5,1598,1618
YNL132W,34,17,6,1609,1643
YNL132W,25,17,7,1772,1797
YNL132W,28,17,8,1976,2004
YNL132W,58,17,9,2131,2189
YNL132W,16,17,10,2196,2212
YNL132W,30,17,11,2233,2263
YNL132W,22,17,12,2290,2312
YNL132W,45,17,13,2454,2499
YNL132W,24,17,14,2668,2692
YNL132W,28,17,15,2731,2759
YNL132W,34,17,16,2748,2782
YNL132W,31,17,17,2886,2917
YKL125W,29,2,1,788,817
YKL125W,18,2,2,1268,1286
YKL170W,22,5,1,253,275
YKL170W,65,5,2,264,329
YKL170W,21,5,3,332,353
YKL170W,22,5,4,358,380
YKL170W,30,5,5,382,412
YJR025C,24,3,1,423,447
YJR025C,19,3,2,449,468
YJR025C,28,3,3,506,534
YLR208W,33,6,1,223,256
YLR208W,23,6,2,306,329
YLR208W,46,6,3,499,545
YLR208W,66,6,4,661,727
YLR208W,63,6,5,752,815
YLR208W,36,6,6,821,857
YDR267C,66,11,1,159,225
YDR267C,36,11,2,236,272
YDR267C,30,11,3,275,305
YDR267C,25,11,4,327,352
YDR267C,58,11,5,353,411
YDR267C,48,11,6,403,451
YDR267C,34,11,7,485,519
YDR267C,19,11,8,520,539
YDR267C,21,11,9,701,722
YDR267C,70,11,10,789,859
YDR267C,16,11,11,891,907
YNL016W,17,1,1,1328,1345
YJL208C,34,4,1,511,545
YJL208C,36,4,2,547,583
YJL208C,30,4,3,665,695
YJL208C,17,4,4,696,713
YLR384C,53,16,1,630,683
YLR384C,45,16,2,855,900
YLR384C,38,16,3,969,1007
YLR384C,40,16,4,1264,1304
YLR384C,60,16,5,1975,2035
YLR384C,27,16,6,2267,2294
YLR384C,22,16,7,2574,2596
YLR384C,21,16,8,2824,2845
YLR384C,15,16,9,2868,2883
YLR384C,46,16,10,2875,2921
YLR384C,21,16,11,3174,3195
YLR384C,15,16,12,3275,3290
YLR384C,40,16,13,3465,3505
YLR384C,28,16,14,3517,3545
YLR384C,16,16,15,3657,3673
YLR384C,26,16,16,3663,3689
YLR421C,27,1,1,192,219
YDR161W,58,1,1,985,1043
YLR090W,20,3,1,618,638
YLR090W,17,3,2,1124,1141
YLR090W,36,3,3,1142,1178
YJR064W,118,8,1,891,1009
YJR064W,64,8,2,1198,1262
YJR064W,33,8,3,1308,1341
YJR064W,57,8,4,1349,1406
YJR064W,26,8,5,1423,1449
YJR064W,15,8,6,1457,1472
YJR064W,40,8,7,1528,1568
YJR064W,71,8,8,1618,1689
YNL183C,18,8,1,647,665
YNL183C,24,8,2,859,883
YNL183C,23,8,3,1434,1457
YNL183C,46,8,4,1528,1574
YNL183C,18,8,5,1575,1593
YNL183C,17,8,6,1608,1625
YNL183C,21,8,7,2002,2023
YNL183C,28,8,8,2036,2064
YOR285W,41,1,1,258,299
YML022W,28,1,1,235,263
YCR065W,26,4,1,1230,1256
YCR065W,33,4,2,1282,1315
YCR065W,33,4,3,1322,1355
YCR065W,39,4,4,1599,1638
YJR031C,24,10,1,346,370
YJR031C,40,10,2,372,412
YJR031C,20,10,3,440,460
YJR031C,15,10,4,1464,1479
YJR031C,16,10,5,2370,2386
YJR031C,18,10,6,2619,2637
YJR031C,21,10,7,2646,2667
YJR031C,32,10,8,2889,2921
YJR031C,39,10,9,3633,3672
YJR031C,21,10,10,4159,4180
YPR159W,63,4,1,284,347
YPR159W,56,4,2,438,494
YPR159W,26,4,3,643,669
YPR159W,22,4,4,1996,2018
YDR074W,26,13,1,302,328
YDR074W,35,13,2,332,367
YDR074W,37,13,3,422,459
YDR074W,41,13,4,554,595
YDR074W,32,13,5,869,901
YDR074W,22,13,6,1461,1483
YDR074W,25,13,7,1711,1736
YDR074W,18,13,8,1829,1847
YDR074W,18,13,9,1900,1918
YDR074W,23,13,10,2128,2151
YDR074W,45,13,11,2257,2302
YDR074W,52,13,12,2309,2361
YDR074W,33,13,13,2348,2381
YPR075C,39,7,1,449,488
YPR075C,15,7,2,521,536
YPR075C,30,7,3,756,786
YPR075C,46,7,4,789,835
YPR075C,17,7,5,861,878
YPR075C,34,7,6,881,915
YPR075C,71,7,7,916,987
YML053C,32,1,1,300,332
YAL014C,43,1,1,420,463
YFL049W,17,10,1,210,227
YFL049W,87,10,2,217,304
YFL049W,29,10,3,874,903
YFL049W,45,10,4,1041,1086
YFL049W,15,10,5,1104,1119
YFL049W,45,10,6,1334,1379
YFL049W,15,10,7,1380,1395
YFL049W,21,10,8,1484,1505
YFL049W,15,10,9,1566,1581
YFL049W,18,10,10,1603,1621
YKR018C,16,4,1,251,267
YKR018C,23,4,2,1494,1517
YKR018C,28,4,3,1991,2019
YKR018C,47,4,4,2121,2168
YNL309W,158,6,1,473,631
YNL309W,38,6,2,726,764
YNL309W,21,6,3,789,810
YNL309W,26,6,4,957,983
YNL309W,26,6,5,1074,1100
YNL309W,41,6,6,1125,1166
YER099C,17,3,1,173,190
YER099C,25,3,2,255,280
YER099C,33,3,3,842,875
YDL150W,77,2,1,716,793
YDL150W,36,2,2,780,816
YOR171C,15,5,1,675,690
YOR171C,48,5,2,852,900
YOR171C,28,5,3,902,930
YOR171C,21,5,4,1365,1386
YOR171C,19,5,5,1387,1406
YHR084W,24,11,1,348,372
YHR084W,76,11,2,394,470
YHR084W,36,11,3,457,493
YHR084W,20,11,4,1761,1781
YHR084W,39,11,5,1784,1823
YHR084W,20,11,6,1834,1854
YHR084W,15,11,7,1856,1871
YHR084W,15,11,8,1925,1940
YHR084W,23,11,9,1947,1970
YHR084W,18,11,10,2022,2040
YHR084W,20,11,11,2045,2065
YKL003C,38,1,1,252,290
YBR218C,24,19,1,685,709
YBR218C,79,19,2,908,987
YBR218C,34,19,3,987,1021
YBR218C,16,19,4,1212,1228
YBR218C,18,19,5,1242,1260
YBR218C,32,19,6,1267,1299
YBR218C,56,19,7,1652,1708
YBR218C,36,19,8,1797,1833
YBR218C,48,19,9,1854,1902
YBR218C,26,19,10,1996,2022
YBR218C,38,19,11,2046,2084
YBR218C,17,19,12,2495,2512
YBR218C,30,19,13,2676,2706
YBR218C,27,19,14,3042,3069
YBR218C,42,19,15,3071,3113
YBR218C,26,19,16,3123,3149
YBR218C,62,19,17,3156,3218
YBR218C,18,19,18,3221,3239
YBR218C,58,19,19,3453,3511
YGL095C,17,10,1,352,369
YGL095C,17,10,2,373,390
YGL095C,29,10,3,377,406
YGL095C,24,10,4,473,497
YGL095C,45,10,5,776,821
YGL095C,22,10,6,969,991
YGL095C,25,10,7,1020,1045
YGL095C,48,10,8,1039,1087
YGL095C,38,10,9,1159,1197
YGL095C,32,10,10,1599,1631
YBR257W,23,3,1,435,458
YBR257W,27,3,2,784,811
YBR257W,30,3,3,806,836
YPL028W,85,7,1,638,723
YPL028W,26,7,2,750,776
YPL028W,60,7,3,790,850
YPL028W,15,7,4,926,941
YPL028W,67,7,5,942,1009
YPL028W,90,7,6,1010,1100
YPL028W,84,7,7,1103,1187
YLR359W,24,7,1,562,586
YLR359W,40,7,2,647,687
YLR359W,21,7,3,806,827
YLR359W,26,7,4,949,975
YLR359W,22,7,5,1038,1060
YLR359W,57,7,6,1051,1108
YLR359W,57,7,7,1208,1265
YHR069C,24,3,1,414,438
YHR069C,55,3,2,426,481
YHR069C,16,3,3,716,732
YGR133W,38,1,1,208,246
YGR142W,29,6,1,279,308
YGR142W,38,6,2,550,588
YGR142W,21,6,3,630,651
YGR142W,20,6,4,728,748
YGR142W,25,6,5,1027,1052
YGR142W,28,6,6,1145,1173
YBR175W,18,4,1,698,716
YBR175W,41,4,2,712,753
YBR175W,17,4,3,760,777
YBR175W,49,4,4,790,839
YHR005C,29,6,1,261,290
YHR005C,16,6,2,334,350
YHR005C,20,6,3,479,499
YHR005C,37,6,4,626,663
YHR005C,28,6,5,1250,1278
YHR005C,39,6,6,1332,1371
YJL081C,19,14,1,364,383
YJL081C,17,14,2,592,609
YJL081C,33,14,3,633,666
YJL081C,36,14,4,734,770
YJL081C,55,14,5,771,826
YJL081C,16,14,6,938,954
YJL081C,16,14,7,960,976
YJL081C,19,14,8,1031,1050
YJL081C,22,14,9,1142,1164
YJL081C,15,14,10,1220,1235
YJL081C,36,14,11,1250,1286
YJL081C,61,14,12,1329,1390
YJL081C,17,14,13,1392,1409
YJL081C,31,14,14,1427,1458
YPL198W,22,1,1,403,425
YKL192C,152,1,1,200,352
YGL082W,35,3,1,416,451
YGL082W,43,3,2,602,645
YGL082W,110,3,3,756,866
YPL146C,60,5,1,717,777
YPL146C,67,5,2,781,848
YPL146C,18,5,3,1056,1074
YPL146C,54,5,4,1152,1206
YPL146C,25,5,5,1293,1318
YPL139C,28,3,1,338,366
YPL139C,48,3,2,378,426
YPL139C,22,3,3,863,885
YNL138W,16,9,1,179,195
YNL138W,27,9,2,212,239
YNL138W,35,9,3,354,389
YNL138W,21,9,4,518,539
YNL138W,15,9,5,567,582
YNL138W,37,9,6,589,626
YNL138W,58,9,7,700,758
YNL138W,33,9,8,821,854
YNL138W,52,9,9,1358,1410
YPL100W,26,3,1,561,587
YPL100W,26,3,2,972,998
YPL100W,29,3,3,1431,1460
YPR098C,77,1,1,406,483
YNL001W,48,2,1,310,358
YNL001W,19,2,2,791,810
YDL236W,49,2,1,325,374
YDL236W,47,2,2,451,498
YJL080C,34,9,1,704,738
YJL080C,20,9,2,779,799
YJL080C,23,9,3,859,882
YJL080C,148,9,4,989,1137
YJL080C,16,9,5,1143,1159
YJL080C,66,9,6,1948,2014
YJL080C,22,9,7,2870,2892
YJL080C,30,9,8,3529,3559
YJL080C,46,9,9,3560,3606
YIL046W,37,3,1,1382,1419
YIL046W,22,3,2,1466,1488
YIL046W,24,3,3,1737,1761
YFR009W,28,4,1,533,561
YFR009W,19,4,2,844,863
YFR009W,42,4,3,850,892
YFR009W,23,4,4,1606,1629
YGR179C,41,2,1,510,551
YGR179C,31,2,2,1091,1122
YGR102C,63,2,1,264,327
YGR102C,19,2,2,494,513
YJL137C,40,2,1,767,807
YJL137C,22,2,2,1075,1097
YBR115C,35,14,1,186,221
YBR115C,18,14,2,344,362
YBR115C,18,14,3,939,957
YBR115C,35,14,4,1152,1187
YBR115C,57,14,5,1560,1617
YBR115C,31,14,6,1614,1645
YBR115C,58,14,7,1696,1754
YBR115C,147,14,8,1808,1955
YBR115C,65,14,9,1959,2024
YBR115C,37,14,10,2069,2106
YBR115C,46,14,11,2221,2267
YBR115C,38,14,12,3351,3389
YBR115C,35,14,13,3377,3412
YBR115C,24,14,14,3819,3843
YDR448W,21,6,1,623,644
YDR448W,37,6,2,680,717
YDR448W,42,6,3,875,917
YDR448W,15,6,4,919,934
YDR448W,35,6,5,959,994
YDR448W,22,6,6,1271,1293
YJR111C,24,2,1,459,483
YJR111C,28,2,2,485,513
YFL023W,44,7,1,234,278
YFL023W,44,7,2,359,403
YFL023W,30,7,3,1084,1114
YFL023W,15,7,4,1469,1484
YFL023W,23,7,5,1674,1697
YFL023W,29,7,6,2078,2107
YFL023W,25,7,7,2322,2347
YOR184W,41,4,1,272,313
YOR184W,133,4,2,412,545
YOR184W,29,4,3,540,569
YOR184W,33,4,4,797,830
YNL116W,89,5,1,1119,1208
YNL116W,27,5,2,1237,1264
YNL116W,36,5,3,1268,1304
YNL116W,16,5,4,1499,1515
YNL116W,35,5,5,1517,1552
YDR092W,59,1,1,350,409
YNL139C,18,7,1,536,554
YNL139C,16,7,2,2990,3006
YNL139C,21,7,3,3250,3271
YNL139C,53,7,4,4473,4526
YNL139C,78,7,5,4623,4701
YNL139C,21,7,6,4710,4731
YNL139C,24,7,7,4734,4758
YDR361C,17,3,1,453,470
YDR361C,30,3,2,777,807
YDR361C,29,3,3,795,824
YBR171W,32,1,1,207,239
YNL005C,29,2,1,739,768
YNL005C,16,2,2,1085,1101
YJL157C,28,21,1,394,422
YJL157C,40,21,2,890,930
YJL157C,46,21,3,1062,1108
YJL157C,18,21,4,1233,1251
YJL157C,45,21,5,1297,1342
YJL157C,35,21,6,1355,1390
YJL157C,17,21,7,1407,1424
YJL157C,15,21,8,1428,1443
YJL157C,16,21,9,1448,1464
YJL157C,38,21,10,1512,1550
YJL157C,46,21,11,1551,1597
YJL157C,34,21,12,1634,1668
YJL157C,39,21,13,1657,1696
YJL157C,30,21,14,1737,1767
YJL157C,23,21,15,1797,1820
YJL157C,40,21,16,1883,1923
YJL157C,23,21,17,1971,1994
YJL157C,46,21,18,2165,2211
YJL157C,29,21,19,2343,2372
YJL157C,33,21,20,2420,2453
YJL157C,30,21,21,2449,2479
YHR206W,28,2,1,1133,1161
YHR206W,57,2,2,1226,1283
YKL181W,207,11,1,139,346
YKL181W,112,11,2,354,466
YKL181W,26,11,3,469,495
YKL181W,66,11,4,496,562
YKL181W,32,11,5,631,663
YKL181W,17,11,6,669,686
YKL181W,18,11,7,689,707
YKL181W,102,11,8,769,871
YKL181W,17,11,9,872,889
YKL181W,31,11,10,883,914
YKL181W,28,11,11,1207,1235
YDL229W,46,12,1,197,243
YDL229W,20,12,2,252,272
YDL229W,15,12,3,278,293
YDL229W,23,12,4,310,333
YDL229W,103,12,5,359,462
YDL229W,46,12,6,469,515
YDL229W,44,12,7,544,588
YDL229W,55,12,8,593,648
YDL229W,78,12,9,783,861
YDL229W,29,12,10,849,878
YDL229W,33,12,11,1039,1072
YDL229W,32,12,12,1474,1506
YOL032W,32,1,1,239,271
YML063W,176,3,1,354,530
YML063W,63,3,2,581,644
YML063W,62,3,3,658,720
YHR027C,57,10,1,415,472
YHR027C,48,10,2,734,782
YHR027C,62,10,3,850,912
YHR027C,22,10,4,974,996
YHR027C,19,10,5,1793,1812
YHR027C,20,10,6,1995,2015
YHR027C,65,10,7,2149,2214
YHR027C,31,10,8,2622,2653
YHR027C,48,10,9,2742,2790
YHR027C,46,10,10,2842,2888
YKL075C,36,1,1,514,550
YFR007W,46,3,1,525,571
YFR007W,20,3,2,610,630
YFR007W,24,3,3,884,908
YJL180C,17,2,1,178,195
YJL180C,50,2,2,196,246
YKR090W,33,5,1,1018,1051
YKR090W,17,5,2,1335,1352
YKR090W,27,5,3,1439,1466
YKR090W,29,5,4,1788,1817
YKR090W,29,5,5,2012,2041
YHL030W,18,13,1,352,370
YHL030W,37,13,2,414,451
YHL030W,17,13,3,1571,1588
YHL030W,29,13,4,1975,2004
YHL030W,30,13,5,2723,2753
YHL030W,18,13,6,3554,3572
YHL030W,26,13,7,3575,3601
YHL030W,25,13,8,3721,3746
YHL030W,24,13,9,4063,4087
YHL030W,34,13,10,4765,4799
YHL030W,27,13,11,4809,4836
YHL030W,30,13,12,5052,5082
YHL030W,18,13,13,5100,5118
YBR200W,33,7,1,611,644
YBR200W,18,7,2,649,667
YBR200W,19,7,3,1166,1185
YBR200W,43,7,4,1186,1229
YBR200W,36,7,5,1566,1602
YBR200W,19,7,6,1615,1634
YBR200W,31,7,7,1621,1652
YNL262W,43,19,1,734,777
YNL262W,29,19,2,875,904
YNL262W,15,19,3,1238,1253
YNL262W,22,19,4,1255,1277
YNL262W,19,19,5,1606,1625
YNL262W,20,19,6,1628,1648
YNL262W,18,19,7,1657,1675
YNL262W,18,19,8,1973,1991
YNL262W,19,19,9,2161,2180
YNL262W,21,19,10,2501,2522
YNL262W,28,19,11,2557,2585
YNL262W,26,19,12,3045,3071
YNL262W,20,19,13,3195,3215
YNL262W,27,19,14,3295,3322
YNL262W,30,19,15,3312,3342
YNL262W,50,19,16,3408,3458
YNL262W,41,19,17,3795,3836
YNL262W,17,19,18,4340,4357
YNL262W,21,19,19,5198,5219
YGL077C,44,1,1,229,273
YPL204W,35,5,1,605,640
YPL204W,33,5,2,925,958
YPL204W,31,5,3,945,976
YPL204W,28,5,4,1144,1172
YPL204W,18,5,5,1217,1235
YOL069W,17,3,1,250,267
YOL069W,25,3,2,581,606
YOL069W,18,3,3,788,806
YKL184W,17,5,1,447,464
YKL184W,16,5,2,466,482
YKL184W,45,5,3,609,654
YKL184W,65,5,4,757,822
YKL184W,30,5,5,1150,1180
YDR412W,32,1,1,523,555
YIL009C-A,54,1,1,178,232
YOR352W,35,2,1,810,845
YOR352W,17,2,2,912,929
YOR091W,42,2,1,237,279
YOR091W,25,2,2,686,711
YBR157C,15,6,1,342,357
YBR157C,49,6,2,414,463
YBR157C,15,6,3,465,480
YBR157C,15,6,4,492,507
YBR157C,26,6,5,633,659
YBR157C,50,6,6,648,698
YNL284C,39,2,1,459,498
YNL284C,17,2,2,901,918
YHR071W,17,1,1,453,470
YOR355W,42,1,1,353,395
YGR086C,77,3,1,539,616
YGR086C,36,3,2,709,745
YGR086C,58,3,3,926,984
YIL026C,17,4,1,987,1004
YIL026C,30,4,2,1698,1728
YIL026C,27,4,3,2556,2583
YIL026C,63,4,4,2922,2985
YGL151W,16,4,1,502,518
YGL151W,21,4,2,1349,1370
YGL151W,37,4,3,1371,1408
YGL151W,35,4,4,1395,1430
YBR197C,30,1,1,624,654
YHR147C,28,2,1,244,272
YHR147C,25,2,2,300,325
YJR091C,63,6,1,350,413
YJR091C,32,6,2,1332,1364
YJR091C,16,6,3,2065,2081
YJR091C,58,6,4,2202,2260
YJR091C,35,6,5,2342,2377
YJR091C,15,6,6,2823,2838
YHR038W,15,5,1,194,209
YHR038W,171,5,2,211,382
YHR038W,24,5,3,397,421
YHR038W,30,5,4,458,488
YHR038W,50,5,5,578,628
YGR124W,72,13,1,206,278
YGR124W,17,13,2,364,381
YGR124W,55,13,3,382,437
YGR124W,73,13,4,523,596
YGR124W,36,13,5,627,663
YGR124W,35,13,6,692,727
YGR124W,63,13,7,778,841
YGR124W,46,13,8,1139,1185
YGR124W,49,13,9,1186,1235
YGR124W,95,13,10,1416,1511
YGR124W,71,13,11,1513,1584
YGR124W,71,13,12,1583,1654
YGR124W,22,13,13,1688,1710
YPL126W,25,6,1,261,286
YPL126W,72,6,2,289,361
YPL126W,33,6,3,447,480
YPL126W,54,6,4,1387,1441
YPL126W,50,6,5,1495,1545
YPL126W,26,6,6,1958,1984
YJR142W,105,4,1,614,719
YJR142W,24,4,2,821,845
YJR142W,24,4,3,847,871
YJR142W,32,4,4,919,951
YFL026W,33,1,1,1173,1206
YJL197W,48,12,1,485,533
YJL197W,53,12,2,522,575
YJL197W,26,12,3,926,952
YJL197W,30,12,4,1136,1166
YJL197W,17,12,5,1562,1579
YJL197W,27,12,6,1721,1748
YJL197W,40,12,7,2641,2681
YJL197W,17,12,8,2945,2962
YJL197W,34,12,9,3140,3174
YJL197W,48,12,10,3342,3390
YJL197W,20,12,11,3545,3565
YJL197W,42,12,12,3577,3619
YOR251C,121,2,1,204,325
YOR251C,35,2,2,312,347
YPR181C,75,17,1,276,351
YPR181C,20,17,2,361,381
YPR181C,35,17,3,472,507
YPR181C,40,17,4,653,693
YPR181C,28,17,5,696,724
YPR181C,45,17,6,786,831
YPR181C,86,17,7,1104,1190
YPR181C,39,17,8,1192,1231
YPR181C,26,17,9,1235,1261
YPR181C,41,17,10,1280,1321
YPR181C,20,17,11,1383,1403
YPR181C,21,17,12,1404,1425
YPR181C,20,17,13,1592,1612
YPR181C,73,17,14,1599,1672
YPR181C,35,17,15,1668,1703
YPR181C,45,17,16,1800,1845
YPR181C,26,17,17,2084,2110
YCL008C,16,1,1,274,290
YDR529C,27,2,1,210,237
YDR529C,56,2,2,320,376
YGR044C,16,6,1,489,505
YGR044C,31,6,2,606,637
YGR044C,42,6,3,638,680
YGR044C,16,6,4,701,717
YGR044C,36,6,5,723,759
YGR044C,28,6,6,860,888
YOR204W,44,4,1,274,318
YOR204W,91,4,2,862,953
YOR204W,64,4,3,962,1026
YOR204W,24,4,4,1653,1677
YEL012W,33,3,1,215,248
YEL012W,40,3,2,245,285
YEL012W,26,3,3,587,613
YDL006W,35,1,1,610,645
YER123W,36,3,1,545,581
YER123W,21,3,2,728,749
YER123W,17,3,3,972,989
YJL012C,32,8,1,308,340
YJL012C,39,8,2,387,426
YJL012C,28,8,3,587,615
YJL012C,24,8,4,992,1016
YJL012C,220,8,5,1026,1246
YJL012C,45,8,6,1408,1453
YJL012C,20,8,7,1474,1494
YJL012C,27,8,8,2013,2040
YLL008W,22,6,1,914,936
YLL008W,21,6,2,1052,1073
YLL008W,25,6,3,1408,1433
YLL008W,17,6,4,1443,1460
YLL008W,38,6,5,1482,1520
YLL008W,18,6,6,2171,2189
YDR505C,16,6,1,1285,1301
YDR505C,42,6,2,1707,1749
YDR505C,18,6,3,2271,2289
YDR505C,27,6,4,2402,2429
YDR505C,20,6,5,2467,2487
YDR505C,24,6,6,2488,2512
YKL206C,38,2,1,372,410
YKL206C,29,2,2,513,542
YLR022C,17,3,1,329,346
YLR022C,49,3,2,487,536
YLR022C,27,3,3,562,589
YOR246C,16,2,1,631,647
YOR246C,30,2,2,638,668
YPL226W,75,18,1,580,655
YPL226W,58,18,2,691,749
YPL226W,99,18,3,1603,1702
YPL226W,46,18,4,1793,1839
YPL226W,21,18,5,1966,1987
YPL226W,24,18,6,2321,2345
YPL226W,30,18,7,2333,2363
YPL226W,46,18,8,2405,2451
YPL226W,16,18,9,2585,2601
YPL226W,31,18,10,2600,2631
YPL226W,18,18,11,2684,2702
YPL226W,21,18,12,2704,2725
YPL226W,15,18,13,2748,2763
YPL226W,60,18,14,2779,2839
YPL226W,20,18,15,2983,3003
YPL226W,36,18,16,3011,3047
YPL226W,30,18,17,3263,3293
YPL226W,24,18,18,3559,3583
YLR375W,27,3,1,207,234
YLR375W,31,3,2,881,912
YLR375W,18,3,3,932,950
YGL039W,54,3,1,365,419
YGL039W,15,3,2,632,647
YGL039W,23,3,3,663,686
YER183C,20,1,1,460,480
YOL021C,62,18,1,203,265
YOL021C,41,18,2,497,538
YOL021C,17,18,3,549,566
YOL021C,38,18,4,674,712
YOL021C,19,18,5,778,797
YOL021C,22,18,6,1004,1026
YOL021C,15,18,7,1306,1321
YOL021C,57,18,8,1424,1481
YOL021C,27,18,9,1492,1519
YOL021C,44,18,10,1855,1899
YOL021C,72,18,11,1971,2043
YOL021C,20,18,12,2060,2080
YOL021C,33,18,13,2109,2142
YOL021C,22,18,14,2177,2199
YOL021C,16,18,15,2417,2433
YOL021C,15,18,16,2580,2595
YOL021C,38,18,17,2641,2679
YOL021C,24,18,18,2948,2972
YBR104W,56,4,1,295,351
YBR104W,24,4,2,445,469
YBR104W,59,4,3,628,687
YBR104W,19,4,4,761,780
YHR030C,26,3,1,310,336
YHR030C,15,3,2,1152,1167
YHR030C,52,3,3,1357,1409
YMR319C,59,4,1,207,266
YMR319C,29,4,2,269,298
YMR319C,36,4,3,369,405
YMR319C,48,4,4,407,455
YBR085W,41,1,1,705,746
YKL018W,30,2,1,251,281
YKL018W,71,2,2,527,598
YEL034W,22,2,1,223,245
YEL034W,19,2,2,274,293
YHL001W,33,1,1,191,224
YNR050C,20,10,1,233,253
YNR050C,27,10,2,258,285
YNR050C,50,10,3,322,372
YNR050C,26,10,4,410,436
YNR050C,21,10,5,466,487
YNR050C,43,10,6,554,597
YNR050C,82,10,7,750,832
YNR050C,25,10,8,980,1005
YNR050C,48,10,9,1104,1152
YNR050C,31,10,10,1209,1240
YKR100C,41,2,1,210,251
YKR100C,28,2,2,520,548
YGR180C,31,3,1,242,273
YGR180C,47,3,2,823,870
YGR180C,23,3,3,1015,1038
YOR260W,35,7,1,531,566
YOR260W,20,7,2,683,703
YOR260W,71,7,3,939,1010
YOR260W,34,7,4,1171,1205
YOR260W,29,7,5,1246,1275
YOR260W,57,7,6,1493,1550
YOR260W,159,7,7,1551,1710
YPL260W,45,5,1,301,346
YPL260W,22,5,2,559,581
YPL260W,21,5,3,990,1011
YPL260W,19,5,4,1384,1403
YPL260W,45,5,5,1437,1482
YML110C,36,1,1,642,678
YNR016C,33,35,1,189,222
YNR016C,49,35,2,359,408
YNR016C,48,35,3,740,788
YNR016C,91,35,4,860,951
YNR016C,29,35,5,985,1014
YNR016C,68,35,6,1015,1083
YNR016C,90,35,7,1087,1177
YNR016C,31,35,8,1508,1539
YNR016C,51,35,9,1732,1783
YNR016C,19,35,10,2029,2048
YNR016C,16,35,11,2176,2192
YNR016C,52,35,12,2267,2319
YNR016C,35,35,13,2789,2824
YNR016C,25,35,14,2979,3004
YNR016C,27,35,15,3090,3117
YNR016C,51,35,16,3426,3477
YNR016C,65,35,17,3491,3556
YNR016C,25,35,18,3733,3758
YNR016C,37,35,19,3842,3879
YNR016C,41,35,20,4069,4110
YNR016C,47,35,21,4368,4415
YNR016C,39,35,22,4403,4442
YNR016C,92,35,23,4576,4668
YNR016C,43,35,24,4716,4759
YNR016C,33,35,25,4959,4992
YNR016C,37,35,26,5338,5375
YNR016C,41,35,27,5362,5403
YNR016C,35,35,28,5598,5633
YNR016C,49,35,29,5666,5715
YNR016C,86,35,30,5746,5832
YNR016C,28,35,31,6065,6093
YNR016C,29,35,32,6243,6272
YNR016C,50,35,33,6294,6344
YNR016C,31,35,34,6494,6525
YNR016C,49,35,35,6608,6657
YOL010W,17,5,1,421,438
YOL010W,22,5,2,448,470
YOL010W,23,5,3,573,596
YOL010W,21,5,4,600,621
YOL010W,23,5,5,756,779
YGL048C,204,8,1,177,381
YGL048C,176,8,2,383,559
YGL048C,329,8,3,566,895
YGL048C,22,8,4,908,930
YGL048C,37,8,5,980,1017
YGL048C,81,8,6,1019,1100
YGL048C,29,8,7,1101,1130
YGL048C,71,8,8,1143,1214
YOR083W,19,1,1,316,335
YMR193W,38,1,1,566,604
YCR053W,17,5,1,280,297
YCR053W,21,5,2,417,438
YCR053W,32,5,3,435,467
YCR053W,48,5,4,942,990
YCR053W,21,5,5,1364,1385
YER072W,33,1,1,227,260
YKL106W,47,4,1,192,239
YKL106W,19,4,2,271,290
YKL106W,36,4,3,359,395
YKL106W,26,4,4,544,570
YGL019W,35,2,1,238,273
YGL019W,57,2,2,656,713
YNL330C,24,5,1,175,199
YNL330C,53,5,2,313,366
YNL330C,47,5,3,915,962
YNL330C,30,5,4,1007,1037
YNL330C,41,5,5,1188,1229
YPR029C,27,3,1,267,294
YPR029C,36,3,2,945,981
YPR029C,38,3,3,1248,1286
YJL034W,50,1,1,168,218
YLR420W,23,6,1,293,316
YLR420W,15,6,2,561,576
YLR420W,84,6,3,799,883
YLR420W,30,6,4,887,917
YLR420W,82,6,5,932,1014
YLR420W,29,6,6,1052,1081
YCR088W,17,4,1,471,488
YCR088W,23,4,2,492,515
YCR088W,44,4,3,1067,1111
YCR088W,31,4,4,1287,1318
YDR208W,18,5,1,614,632
YDR208W,25,5,2,762,787
YDR208W,16,5,3,1690,1706
YDR208W,30,5,4,1762,1792
YDR208W,22,5,5,1902,1924
YBR091C,20,1,1,270,290
YDR075W,44,2,1,419,463
YDR075W,21,2,2,866,887
YGR220C,31,4,1,206,237
YGR220C,15,4,2,521,536
YGR220C,15,4,3,669,684
YGR220C,30,4,4,697,727
YDL153C,27,2,1,827,854
YDL153C,22,2,2,986,1008
YOR176W,19,5,1,570,589
YOR176W,45,5,2,726,771
YOR176W,41,5,3,797,838
YOR176W,48,5,4,827,875
YOR176W,75,5,5,929,1004
YHR187W,32,1,1,515,547
YDL108W,46,5,1,223,269
YDL108W,33,5,2,406,439
YDL108W,31,5,3,741,772
YDL108W,36,5,4,770,806
YDL108W,20,5,5,884,904
YGR275W,23,2,1,206,229
YGR275W,15,2,2,406,421
YIR033W,51,5,1,638,689
YIR033W,15,5,2,749,764
YIR033W,31,5,3,860,891
YIR033W,30,5,4,2326,2356
YIR033W,22,5,5,3251,3273
YDL084W,31,7,1,433,464
YDL084W,21,7,2,542,563
YDL084W,20,7,3,574,594
YDL084W,74,7,4,612,686
YDL084W,33,7,5,719,752
YDL084W,47,7,6,875,922
YDL084W,31,7,7,909,940
YGR208W,32,4,1,566,598
YGR208W,17,4,2,640,657
YGR208W,33,4,3,648,681
YGR208W,33,4,4,687,720
YPL059W,17,1,1,197,214
YMR120C,37,10,1,329,366
YMR120C,67,10,2,535,602
YMR120C,30,10,3,589,619
YMR120C,52,10,4,726,778
YMR120C,38,10,5,1056,1094
YMR120C,29,10,6,1224,1253
YMR120C,23,10,7,1425,1448
YMR120C,40,10,8,1504,1544
YMR120C,24,10,9,1569,1593
YMR120C,16,10,10,1718,1734
YCL055W,16,2,1,969,985
YCL055W,18,2,2,986,1004
YKL141W,27,2,1,292,319
YKL141W,30,2,2,403,433
YER005W,53,1,1,934,987
YGL116W,30,6,1,838,868
YGL116W,26,6,2,1254,1280
YGL116W,23,6,3,1434,1457
YGL116W,33,6,4,1465,1498
YGL116W,27,6,5,1541,1568
YGL116W,16,6,6,1796,1812
YBL054W,24,6,1,682,706
YBL054W,43,6,2,799,842
YBL054W,18,6,3,1003,1021
YBL054W,27,6,4,1129,1156
YBL054W,44,6,5,1176,1220
YBL054W,38,6,6,1324,1362
YOR194C,52,3,1,277,329
YOR194C,25,3,2,703,728
YOR194C,31,3,3,715,746
YCR008W,16,8,1,648,664
YCR008W,32,8,2,1090,1122
YCR008W,29,8,3,1201,1230
YCR008W,23,8,4,1302,1325
YCR008W,32,8,5,1629,1661
YCR008W,38,8,6,1663,1701
YCR008W,20,8,7,1713,1733
YCR008W,16,8,8,1749,1765
YMR102C,60,4,1,1017,1077
YMR102C,55,4,2,1132,1187
YMR102C,16,4,3,1268,1284
YMR102C,22,4,4,1890,1912
YCR071C,16,2,1,339,355
YCR071C,16,2,2,371,387
YDR175C,30,5,1,528,558
YDR175C,62,5,2,657,719
YDR175C,20,5,3,728,748
YDR175C,90,5,4,753,843
YDR175C,15,5,5,859,874
YPR034W,20,2,1,801,821
YPR034W,25,2,2,1357,1382
YOR189W,51,1,1,286,337
YDL122W,20,6,1,537,557
YDL122W,22,6,2,1512,1534
YDL122W,51,6,3,1674,1725
YDL122W,59,6,4,1749,1808
YDL122W,15,6,5,1919,1934
YDL122W,23,6,6,2244,2267
YIR035C,59,1,1,633,692
YGR007W,69,8,1,353,422
YGR007W,22,8,2,451,473
YGR007W,48,8,3,480,528
YGR007W,22,8,4,533,555
YGR007W,69,8,5,556,625
YGR007W,32,8,6,653,685
YGR007W,19,8,7,828,847
YGR007W,29,8,8,878,907
YNL315C,17,4,1,636,653
YNL315C,50,4,2,814,864
YNL315C,34,4,3,861,895
YNL315C,15,4,4,929,944
YER018C,22,2,1,489,511
YER018C,35,2,2,500,535
YOR299W,24,6,1,211,235
YOR299W,19,6,2,602,621
YOR299W,21,6,3,1261,1282
YOR299W,41,6,4,1359,1400
YOR299W,29,6,5,1659,1688
YOR299W,32,6,6,2119,2151
YJR045C,37,2,1,851,888
YJR045C,72,2,2,1504,1576
YOR056C,35,4,1,155,190
YOR056C,15,4,2,200,215
YOR056C,40,4,3,249,289
YOR056C,38,4,4,1182,1220
YIL125W,39,17,1,512,551
YIL125W,42,17,2,552,594
YIL125W,36,17,3,806,842
YIL125W,26,17,4,864,890
YIL125W,19,17,5,997,1016
YIL125W,29,17,6,1176,1205
YIL125W,17,17,7,1213,1230
YIL125W,28,17,8,1282,1310
YIL125W,33,17,9,1456,1489
YIL125W,45,17,10,1490,1535
YIL125W,19,17,11,1868,1887
YIL125W,35,17,12,1902,1937
YIL125W,19,17,13,1966,1985
YIL125W,28,17,14,1997,2025
YIL125W,21,17,15,2204,2225
YIL125W,24,17,16,2627,2651
YIL125W,24,17,17,2832,2856
YBR141C,34,1,1,703,737
YMR008C,34,2,1,389,423
YMR008C,20,2,2,583,603
YJL136C,67,2,1,155,222
YJL136C,18,2,2,225,243
YDR140W,16,1,1,487,503
YKL112W,24,1,1,1129,1153
YDL171C,51,49,1,741,792
YDL171C,54,49,2,1338,1392
YDL171C,18,49,3,1395,1413
YDL171C,27,49,4,1797,1824
YDL171C,23,49,5,1827,1850
YDL171C,39,49,6,2330,2369
YDL171C,28,49,7,2702,2730
YDL171C,48,49,8,2829,2877
YDL171C,74,49,9,2868,2942
YDL171C,30,49,10,3114,3144
YDL171C,48,49,11,3159,3207
YDL171C,61,49,12,3310,3371
YDL171C,25,49,13,3375,3400
YDL171C,41,49,14,3575,3616
YDL171C,50,49,15,3678,3728
YDL171C,47,49,16,3734,3781
YDL171C,28,49,17,3801,3829
YDL171C,23,49,18,3900,3923
YDL171C,53,49,19,3945,3998
YDL171C,24,49,20,4008,4032
YDL171C,40,49,21,4130,4170
YDL171C,43,49,22,4311,4354
YDL171C,37,49,23,4498,4535
YDL171C,27,49,24,4737,4764
YDL171C,36,49,25,4780,4816
YDL171C,98,49,26,4953,5051
YDL171C,22,49,27,5109,5131
YDL171C,18,49,28,5133,5151
YDL171C,19,49,29,5154,5173
YDL171C,16,49,30,5186,5202
YDL171C,27,49,31,5238,5265
YDL171C,120,49,32,5272,5392
YDL171C,21,49,33,5394,5415
YDL171C,55,49,34,5494,5549
YDL171C,37,49,35,5569,5606
YDL171C,34,49,36,5627,5661
YDL171C,42,49,37,5667,5709
YDL171C,41,49,38,5735,5776
YDL171C,33,49,39,5777,5810
YDL171C,27,49,40,5822,5849
YDL171C,31,49,41,5840,5871
YDL171C,25,49,42,5943,5968
YDL171C,19,49,43,5991,6010
YDL171C,17,49,44,6028,6045
YDL171C,97,49,45,6091,6188
YDL171C,19,49,46,6222,6241
YDL171C,55,49,47,6244,6299
YDL171C,15,49,48,6330,6345
YDL171C,25,49,49,6405,6430
YJR010W,53,3,1,401,454
YJR010W,81,3,2,813,894
YJR010W,45,3,3,881,926
YPR103W,15,3,1,479,494
YPR103W,37,3,2,534,571
YPR103W,39,3,3,677,716
YNR043W,40,6,1,256,296
YNR043W,53,6,2,425,478
YNR043W,42,6,3,706,748
YNR043W,68,6,4,805,873
YNR043W,36,6,5,956,992
YNR043W,19,6,6,1070,1089
YHR165C,38,16,1,510,548
YHR165C,35,16,2,819,854
YHR165C,26,16,3,1305,1331
YHR165C,36,16,4,1352,1388
YHR165C,33,16,5,1675,1708
YHR165C,71,16,6,1892,1963
YHR165C,22,16,7,2042,2064
YHR165C,15,16,8,2190,2205
YHR165C,36,16,9,2242,2278
YHR165C,29,16,10,3533,3562
YHR165C,18,16,11,3615,3633
YHR165C,34,16,12,3938,3972
YHR165C,17,16,13,4934,4951
YHR165C,15,16,14,5001,5016
YHR165C,15,16,15,5661,5676
YHR165C,35,16,16,6666,6701
YJL218W,35,2,1,219,254
YJL218W,31,2,2,255,286
YNL075W,62,2,1,472,534
YNL075W,37,2,2,811,848
YLR222C,15,9,1,375,390
YLR222C,44,9,2,705,749
YLR222C,46,9,3,810,856
YLR222C,32,9,4,1515,1547
YLR222C,15,9,5,1570,1585
YLR222C,44,9,6,1789,1833
YLR222C,42,9,7,1878,1920
YLR222C,16,9,8,2106,2122
YLR222C,19,9,9,2355,2374
YNL162W,45,2,1,216,261
YNL162W,23,2,2,262,285
YIL109C,30,11,1,582,612
YIL109C,66,11,2,739,805
YIL109C,53,11,3,827,880
YIL109C,56,11,4,895,951
YIL109C,21,11,5,1002,1023
YIL109C,51,11,6,1093,1144
YIL109C,49,11,7,1294,1343
YIL109C,34,11,8,1959,1993
YIL109C,38,11,9,2303,2341
YIL109C,15,11,10,2389,2404
YIL109C,39,11,11,2676,2715
YHR046C,24,5,1,474,498
YHR046C,65,5,2,632,697
YHR046C,45,5,3,716,761
YHR046C,27,5,4,836,863
YHR046C,22,5,5,865,887
YPL070W,25,4,1,472,497
YPL070W,20,4,2,1145,1165
YPL070W,26,4,3,1268,1294
YPL070W,54,4,4,1614,1668
YFL022C,36,5,1,450,486
YFL022C,31,5,2,512,543
YFL022C,43,5,3,969,1012
YFL022C,59,5,4,1103,1162
YFL022C,55,5,5,1163,1218
YJL156C,39,3,1,1239,1278
YJL156C,18,3,2,1535,1553
YJL156C,26,3,3,1819,1845
YKL185W,49,8,1,745,794
YKL185W,29,8,2,781,810
YKL185W,30,8,3,1455,1485
YKL185W,53,8,4,1486,1539
YKL185W,18,8,5,1575,1593
YKL185W,16,8,6,1607,1623
YKL185W,17,8,7,1625,1642
YKL185W,56,8,8,1711,1767
YKL180W,47,3,1,317,364
YKL180W,29,3,2,383,412
YKL180W,96,3,3,445,541
YKL166C,50,4,1,879,929
YKL166C,22,4,2,931,953
YKL166C,20,4,3,960,980
YKL166C,32,4,4,1132,1164
YJR007W,348,6,1,128,476
YJR007W,33,6,2,487,520
YJR007W,64,6,3,535,599
YJR007W,72,6,4,606,678
YJR007W,27,6,5,682,709
YJR007W,159,6,6,713,872
YGR211W,20,5,1,409,429
YGR211W,38,5,2,1041,1079
YGR211W,26,5,3,1172,1198
YGR211W,21,5,4,1393,1414
YGR211W,42,5,5,1419,1461
YJL069C,29,7,1,1055,1084
YJL069C,27,7,2,1086,1113
YJL069C,42,7,3,1157,1199
YJL069C,22,7,4,1200,1222
YJL069C,29,7,5,1368,1397
YJL069C,32,7,6,1404,1436
YJL069C,17,7,7,1437,1454
YFL017C,66,1,1,284,350
YNL185C,18,2,1,251,269
YNL185C,16,2,2,317,333
YHR047C,25,3,1,586,611
YHR047C,36,3,2,944,980
YHR047C,17,3,3,1514,1531
YPR132W,82,1,1,337,419
YPR137W,34,3,1,1217,1251
YPR137W,24,3,2,1412,1436
YPR137W,30,3,3,1575,1605
YGL001C,60,3,1,242,302
YGL001C,41,3,2,303,344
YGL001C,15,3,3,693,708
YDL115C,18,1,1,243,261
YPL096W,46,4,1,302,348
YPL096W,43,4,2,666,709
YPL096W,38,4,3,930,968
YPL096W,44,4,4,1013,1057
YDL140C,61,35,1,546,607
YDL140C,31,35,2,770,801
YDL140C,37,35,3,808,845
YDL140C,17,35,4,855,872
YDL140C,78,35,5,1107,1185
YDL140C,26,35,6,1519,1545
YDL140C,64,35,7,1550,1614
YDL140C,26,35,8,1651,1677
YDL140C,26,35,9,1711,1737
YDL140C,20,35,10,1887,1907
YDL140C,48,35,11,1909,1957
YDL140C,43,35,12,1965,2008
YDL140C,80,35,13,2039,2119
YDL140C,16,35,14,2181,2197
YDL140C,60,35,15,2191,2251
YDL140C,18,35,16,2294,2312
YDL140C,27,35,17,2316,2343
YDL140C,51,35,18,2629,2680
YDL140C,30,35,19,2679,2709
YDL140C,22,35,20,2814,2836
YDL140C,93,35,21,2921,3014
YDL140C,19,35,22,3026,3045
YDL140C,38,35,23,3097,3135
YDL140C,39,35,24,3190,3229
YDL140C,33,35,25,3428,3461
YDL140C,105,35,26,3558,3663
YDL140C,15,35,27,3761,3776
YDL140C,26,35,28,3858,3884
YDL140C,62,35,29,3885,3947
YDL140C,59,35,30,4148,4207
YDL140C,25,35,31,4208,4233
YDL140C,17,35,32,4268,4285
YDL140C,50,35,33,4293,4343
YDL140C,37,35,34,4363,4400
YDL140C,48,35,35,4522,4570
YDR304C,29,1,1,176,205
YOR136W,37,8,1,206,243
YOR136W,23,8,2,298,321
YOR136W,37,8,3,376,413
YOR136W,64,8,4,434,498
YOR136W,35,8,5,502,537
YOR136W,26,8,6,652,678
YOR136W,37,8,7,697,734
YOR136W,22,8,8,907,929
YDR266C,25,6,1,999,1024
YDR266C,40,6,2,1262,1302
YDR266C,24,6,3,1634,1658
YDR266C,16,6,4,1659,1675
YDR266C,29,6,5,1692,1721
YDR266C,27,6,6,1884,1911
YGL194C,38,1,1,507,545
YKL091C,34,3,1,577,611
YKL091C,46,3,2,647,693
YKL091C,49,3,3,784,833
YOR116C,73,15,1,931,1004
YOR116C,30,15,2,1164,1194
YOR116C,24,15,3,1200,1224
YOR116C,49,15,4,1587,1636
YOR116C,45,15,5,1645,1690
YOR116C,25,15,6,2001,2026
YOR116C,21,15,7,2358,2379
YOR116C,26,15,8,2421,2447
YOR116C,21,15,9,3194,3215
YOR116C,48,15,10,3319,3367
YOR116C,39,15,11,3426,3465
YOR116C,41,15,12,3647,3688
YOR116C,25,15,13,3912,3937
YOR116C,34,15,14,4087,4121
YOR116C,30,15,15,4142,4172
YKR024C,69,6,1,921,990
YKR024C,19,6,2,1130,1149
YKR024C,17,6,3,1230,1247
YKR024C,16,6,4,1521,1537
YKR024C,52,6,5,1859,1911
YKR024C,19,6,6,2125,2144
YNL037C,37,1,1,501,538
YFL013C,15,3,1,446,461
YFL013C,18,3,2,1391,1409
YFL013C,40,3,3,1428,1468
YPL063W,19,8,1,172,191
YPL063W,23,8,2,197,220
YPL063W,58,8,3,230,288
YPL063W,17,8,4,552,569
YPL063W,67,8,5,1122,1189
YPL063W,15,8,6,1190,1205
YPL063W,23,8,7,1210,1233
YPL063W,22,8,8,1234,1256
YFR040W,30,3,1,1040,1070
YFR040W,35,3,2,2160,2195
YFR040W,46,3,3,2536,2582
YML124C,18,8,1,629,647
YML124C,34,8,2,894,928
YML124C,23,8,3,938,961
YML124C,17,8,4,962,979
YML124C,30,8,5,1010,1040
YML124C,15,8,6,1061,1076
YML124C,31,8,7,1113,1144
YML124C,56,8,8,1270,1326
YOL142W,40,4,1,232,272
YOL142W,20,4,2,278,298
YOL142W,22,4,3,364,386
YOL142W,42,4,4,431,473
YDR287W,17,2,1,271,288
YDR287W,23,2,2,356,379
YOR326W,23,13,1,506,529
YOR326W,15,13,2,908,923
YOR326W,19,13,3,1268,1287
YOR326W,33,13,4,1349,1382
YOR326W,32,13,5,2134,2166
YOR326W,25,13,6,2171,2196
YOR326W,30,13,7,2204,2234
YOR326W,26,13,8,2515,2541
YOR326W,15,13,9,2670,2685
YOR326W,18,13,10,2828,2846
YOR326W,18,13,11,3038,3056
YOR326W,19,13,12,3742,3761
YOR326W,16,13,13,4567,4583
YDR405W,39,1,1,482,521
YGL041W-A,17,1,1,444,461
YCL031C,58,1,1,625,683
YAL041W,29,7,1,329,358
YAL041W,39,7,2,599,638
YAL041W,21,7,3,1370,1391
YAL041W,39,7,4,1393,1432
YAL041W,23,7,5,1966,1989
YAL041W,36,7,6,1991,2027
YAL041W,25,7,7,2029,2054
YLR459W,47,1,1,172,219
YNL243W,15,10,1,221,236
YNL243W,23,10,2,239,262
YNL243W,30,10,3,263,293
YNL243W,15,10,4,310,325
YNL243W,58,10,5,440,498
YNL243W,42,10,6,809,851
YNL243W,112,10,7,853,965
YNL243W,36,10,8,1574,1610
YNL243W,24,10,9,1640,1664
YNL243W,35,10,10,2139,2174
YGR152C,47,1,1,367,414
YJR143C,16,1,1,310,326
YBR196C,16,4,1,263,279
YBR196C,79,4,2,449,528
YBR196C,28,4,3,1005,1033
YBR196C,29,4,4,1181,1210
YLR190W,18,10,1,323,341
YLR190W,23,10,2,360,383
YLR190W,26,10,3,385,411
YLR190W,24,10,4,436,460
YLR190W,16,10,5,517,533
YLR190W,18,10,6,613,631
YLR190W,29,10,7,673,702
YLR190W,21,10,8,988,1009
YLR190W,40,10,9,1049,1089
YLR190W,30,10,10,1321,1351
YGR147C,18,6,1,266,284
YGR147C,37,6,2,285,322
YGR147C,21,6,3,326,347
YGR147C,41,6,4,505,546
YGR147C,33,6,5,707,740
YGR147C,23,6,6,825,848
YDR002W,168,2,1,383,551
YDR002W,28,2,2,578,606
YJR092W,66,25,1,1220,1286
YJR092W,40,25,2,1430,1470
YJR092W,16,25,3,1525,1541
YJR092W,33,25,4,1579,1612
YJR092W,18,25,5,1613,1631
YJR092W,39,25,6,2204,2243
YJR092W,26,25,7,2244,2270
YJR092W,22,25,8,2271,2293
YJR092W,19,25,9,2303,2322
YJR092W,23,25,10,2329,2352
YJR092W,36,25,11,2354,2390
YJR092W,22,25,12,2391,2413
YJR092W,31,25,13,2542,2573
YJR092W,60,25,14,2733,2793
YJR092W,28,25,15,2902,2930
YJR092W,25,25,16,3069,3094
YJR092W,25,25,17,3097,3122
YJR092W,27,25,18,3400,3427
YJR092W,28,25,19,3437,3465
YJR092W,26,25,20,3566,3592
YJR092W,16,25,21,3935,3951
YJR092W,49,25,22,3938,3987
YJR092W,29,25,23,4016,4045
YJR092W,41,25,24,4199,4240
YJR092W,26,25,25,4263,4289
YOR311C,20,3,1,238,258
YOR311C,39,3,2,294,333
YOR311C,39,3,3,378,417
YAL025C,57,4,1,275,332
YAL025C,79,4,2,333,412
YAL025C,39,4,3,495,534
YAL025C,46,4,4,563,609
YPR072W,22,5,1,686,708
YPR072W,48,5,2,908,956
YPR072W,45,5,3,1309,1354
YPR072W,27,5,4,1532,1559
YPR072W,37,5,5,1646,1683
YGL094C,22,10,1,610,632
YGL094C,41,10,2,627,668
YGL094C,17,10,3,1024,1041
YGL094C,23,10,4,1043,1066
YGL094C,20,10,5,1458,1478
YGL094C,26,10,6,1524,1550
YGL094C,46,10,7,1577,1623
YGL094C,15,10,8,2441,2456
YGL094C,20,10,9,2514,2534
YGL094C,19,10,10,2995,3014
YNL039W,22,3,1,1231,1253
YNL039W,25,3,2,1391,1416
YNL039W,20,3,3,1764,1784
YBR170C,37,3,1,795,832
YBR170C,32,3,2,975,1007
YBR170C,19,3,3,1487,1506
YGR130C,21,3,1,956,977
YGR130C,49,3,2,1452,1501
YGR130C,20,3,3,2288,2308
YDL217C,21,1,1,570,591
YGL148W,79,14,1,181,260
YGL148W,19,14,2,268,287
YGL148W,43,14,3,292,335
YGL148W,25,14,4,375,400
YGL148W,265,14,5,405,670
YGL148W,15,14,6,698,713
YGL148W,16,14,7,740,756
YGL148W,53,14,8,757,810
YGL148W,89,14,9,813,902
YGL148W,26,14,10,950,976
YGL148W,30,14,11,980,1010
YGL148W,41,14,12,1022,1063
YGL148W,27,14,13,1068,1095
YGL148W,18,14,14,1104,1122
YKL193C,23,3,1,339,362
YKL193C,27,3,2,589,616
YKL193C,15,3,3,677,692
YGL083W,41,3,1,387,428
YGL083W,18,3,2,1306,1324
YGL083W,33,3,3,1676,1709
YBR214W,20,5,1,533,553
YBR214W,20,5,2,677,697
YBR214W,52,5,3,706,758
YBR214W,26,5,4,850,876
YBR214W,20,5,5,1116,1136
YPL078C,84,3,1,180,264
YPL078C,48,3,2,258,306
YPL078C,81,3,3,411,492
YBR249C,43,2,1,386,429
YBR249C,31,2,2,880,911
YNL287W,56,9,1,245,301
YNL287W,83,9,2,596,679
YNL287W,33,9,3,666,699
YNL287W,20,9,4,1763,1783
YNL287W,18,9,5,1989,2007
YNL287W,42,9,6,2159,2201
YNL287W,22,9,7,2320,2342
YNL287W,37,9,8,2435,2472
YNL287W,33,9,9,2696,2729
YNL102W,26,24,1,999,1025
YNL102W,38,24,2,1227,1265
YNL102W,49,24,3,1279,1328
YNL102W,16,24,4,1382,1398
YNL102W,18,24,5,1405,1423
YNL102W,20,24,6,1428,1448
YNL102W,41,24,7,1479,1520
YNL102W,48,24,8,1775,1823
YNL102W,43,24,9,1871,1914
YNL102W,57,24,10,1915,1972
YNL102W,17,24,11,2007,2024
YNL102W,30,24,12,2011,2041
YNL102W,17,24,13,2666,2683
YNL102W,44,24,14,2719,2763
YNL102W,30,24,15,2919,2949
YNL102W,25,24,16,2978,3003
YNL102W,38,24,17,3008,3046
YNL102W,28,24,18,3325,3353
YNL102W,26,24,19,3521,3547
YNL102W,20,24,20,3592,3612
YNL102W,39,24,21,3617,3656
YNL102W,15,24,22,4055,4070
YNL102W,20,24,23,4137,4157
YNL102W,40,24,24,4353,4393
YOL077C,16,4,1,447,463
YOL077C,22,4,2,549,571
YOL077C,42,4,3,621,663
YOL077C,37,4,4,695,732
YOL086W-A,61,1,1,152,213
YKL209C,19,2,1,811,830
YKL209C,20,2,2,1482,1502
YLR438C-A,44,1,1,173,217
YLR003C,38,3,1,243,281
YLR003C,31,3,2,603,634
YLR003C,127,3,3,665,792
YDL131W,35,5,1,610,645
YDL131W,52,5,2,1114,1166
YDL131W,15,5,3,1207,1222
YDL131W,40,5,4,1241,1281
YDL131W,37,5,5,1282,1319
YLR441C,42,4,1,195,237
YLR441C,170,4,2,355,525
YLR441C,66,4,3,579,645
YLR441C,63,4,4,660,723
YOR261C,28,3,1,248,276
YOR261C,25,3,2,407,432
YOR261C,64,3,3,732,796
YNR051C,88,7,1,321,409
YNR051C,22,7,2,410,432
YNR051C,31,7,3,947,978
YNR051C,51,7,4,1045,1096
YNR051C,35,7,5,1122,1157
YNR051C,80,7,6,1254,1334
YNR051C,63,7,7,1408,1471
YGR187C,32,4,1,453,485
YGR187C,33,4,2,630,663
YGR187C,21,4,3,801,822
YGR187C,17,4,4,1054,1071
YDR056C,28,1,1,491,519
YHL002W,24,5,1,185,209
YHL002W,33,5,2,204,237
YHL002W,23,5,3,446,469
YHL002W,23,5,4,805,828
YHL002W,36,5,5,955,991
YHR122W,38,1,1,636,674
YDR390C,18,6,1,366,384
YDR390C,63,6,2,385,448
YDR390C,35,6,3,441,476
YDR390C,22,6,4,491,513
YDR390C,55,6,5,620,675
YDR390C,23,6,6,682,705
YHR017W,31,1,1,382,413
YPL267W,57,1,1,425,482
YOR229W,17,3,1,885,902
YOR229W,26,3,2,905,931
YOR229W,25,3,3,1057,1082
YEL024W,23,4,1,183,206
YEL024W,20,4,2,420,440
YEL024W,38,4,3,500,538
YEL024W,39,4,4,608,647
YGR005C,81,4,1,350,431
YGR005C,16,4,2,456,472
YGR005C,23,4,3,563,586
YGR005C,29,4,4,1024,1053
YBL032W,25,1,1,604,629
YGL049C,19,4,1,455,474
YGL049C,28,4,2,821,849
YGL049C,22,4,3,2407,2429
YGL049C,17,4,4,2516,2533
YDR023W,17,1,1,427,444
YHL034C,111,1,1,392,503
YOR051C,43,1,1,968,1011
YCR052W,22,2,1,303,325
YCR052W,54,2,2,356,410
YNL209W,57,13,1,191,248
YNL209W,22,13,2,255,277
YNL209W,15,13,3,278,293
YNL209W,34,13,4,301,335
YNL209W,21,13,5,344,365
YNL209W,67,13,6,389,456
YNL209W,54,13,7,463,517
YNL209W,48,13,8,539,587
YNL209W,54,13,9,593,647
YNL209W,70,13,10,782,852
YNL209W,35,13,11,839,874
YNL209W,34,13,12,1042,1076
YNL209W,28,13,13,1810,1838
YOR312C,22,1,1,247,269
YBR272C,94,4,1,247,341
YBR272C,23,4,2,858,881
YBR272C,15,4,3,1250,1265
YBR272C,39,4,4,1254,1293
YDR298C,61,2,1,248,309
YDR298C,16,2,2,398,414
YDR011W,47,7,1,1212,1259
YDR011W,16,7,2,1260,1276
YDR011W,31,7,3,1345,1376
YDR011W,35,7,4,1421,1456
YDR011W,15,7,5,1494,1509
YDR011W,34,7,6,1678,1712
YDR011W,45,7,7,3275,3320
YBL009W,50,10,1,805,855
YBL009W,17,10,2,902,919
YBL009W,23,10,3,1074,1097
YBL009W,38,10,4,1104,1142
YBL009W,21,10,5,1166,1187
YBL009W,37,10,6,1355,1392
YBL009W,15,10,7,1718,1733
YBL009W,36,10,8,1754,1790
YBL009W,20,10,9,1791,1811
YBL009W,18,10,10,1998,2016
YOR272W,130,14,1,157,287
YOR272W,26,14,2,291,317
YOR272W,87,14,3,564,651
YOR272W,18,14,4,668,686
YOR272W,36,14,5,694,730
YOR272W,15,14,6,737,752
YOR272W,19,14,7,764,783
YOR272W,50,14,8,772,822
YOR272W,41,14,9,823,864
YOR272W,41,14,10,1099,1140
YOR272W,31,14,11,1159,1190
YOR272W,53,14,12,1209,1262
YOR272W,51,14,13,1275,1326
YOR272W,49,14,14,1331,1380
YGL254W,34,1,1,687,721
YOL059W,33,1,1,590,623
YFR006W,58,8,1,442,500
YFR006W,33,8,2,501,534
YFR006W,25,8,3,812,837
YFR006W,25,8,4,1211,1236
YFR006W,23,8,5,1244,1267
YFR006W,83,8,6,1419,1502
YFR006W,40,8,7,1509,1549
YFR006W,20,8,8,1551,1571
YHL031C,44,1,1,167,211
YOL151W,34,1,1,708,742
YKL213C,37,14,1,206,243
YKL213C,18,14,2,254,272
YKL213C,56,14,3,273,329
YKL213C,44,14,4,316,360
YKL213C,44,14,5,546,590
YKL213C,27,14,6,609,636
YKL213C,53,14,7,637,690
YKL213C,81,14,8,798,879
YKL213C,27,14,9,902,929
YKL213C,48,14,10,978,1026
YKL213C,25,14,11,1164,1189
YKL213C,60,14,12,1521,1581
YKL213C,16,14,13,1796,1812
YKL213C,18,14,14,1888,1906
YER036C,20,8,1,491,511
YER036C,32,8,2,784,816
YER036C,59,8,3,854,913
YER036C,20,8,4,1052,1072
YER036C,24,8,5,1182,1206
YER036C,20,8,6,1235,1255
YER036C,19,8,7,1430,1449
YER036C,46,8,8,1683,1729
YBR281C,32,7,1,399,431
YBR281C,18,7,2,989,1007
YBR281C,23,7,3,1132,1155
YBR281C,40,7,4,1603,1643
YBR281C,26,7,5,2034,2060
YBR281C,31,7,6,2047,2078
YBR281C,23,7,7,2433,2456
YJL198W,30,7,1,418,448
YJL198W,43,7,2,449,492
YJL198W,21,7,3,514,535
YJL198W,24,7,4,632,656
YJL198W,24,7,5,659,683
YJL198W,25,7,6,1067,1092
YJL198W,27,7,7,1437,1464
YPL207W,15,4,1,182,197
YPL207W,19,4,2,1030,1049
YPL207W,18,4,3,1861,1879
YPL207W,20,4,4,1907,1927
YNL289W,30,5,1,214,244
YNL289W,17,5,2,246,263
YNL289W,25,5,3,264,289
YNL289W,15,5,4,290,305
YNL289W,40,5,5,294,334
YOL135C,24,2,1,215,239
YOL135C,44,2,2,428,472
YOR323C,25,5,1,364,389
YOR323C,32,5,2,422,454
YOR323C,17,5,3,731,748
YOR323C,20,5,4,932,952
YOR323C,45,5,5,1063,1108
YLL041C,50,5,1,448,498
YLL041C,38,5,2,493,531
YLL041C,42,5,3,561,603
YLL041C,15,5,4,604,619
YLL041C,28,5,5,754,782
YML106W,55,2,1,266,321
YML106W,76,2,2,377,453
YBR062C,16,1,1,404,420
YCL054W,21,10,1,295,316
YCL054W,51,10,2,422,473
YCL054W,21,10,3,479,500
YCL054W,39,10,4,530,569
YCL054W,27,10,5,605,632
YCL054W,25,10,6,637,662
YCL054W,32,10,7,853,885
YCL054W,29,10,8,884,913
YCL054W,49,10,9,1603,1652
YCL054W,19,10,10,2476,2495
YLR118C,53,3,1,300,353
YLR118C,54,3,2,512,566
YLR118C,34,3,3,575,609
YLR182W,39,2,1,347,386
YLR182W,64,2,2,1193,1257
YER182W,18,3,1,248,266
YER182W,22,3,2,275,297
YER182W,16,3,3,688,704
YLL034C,15,9,1,390,405
YLL034C,25,9,2,411,436
YLL034C,35,9,3,1079,1114
YLL034C,31,9,4,1222,1253
YLL034C,18,9,5,1578,1596
YLL034C,33,9,6,1885,1918
YLL034C,44,9,7,2023,2067
YLL034C,59,9,8,2147,2206
YLL034C,29,9,9,2428,2457
YBL105C,35,11,1,561,596
YBL105C,27,11,2,833,860
YBL105C,40,11,3,866,906
YBL105C,41,11,4,920,961
YBL105C,18,11,5,965,983
YBL105C,27,11,6,1487,1514
YBL105C,17,11,7,1519,1536
YBL105C,19,11,8,2923,2942
YBL105C,21,11,9,3009,3030
YBL105C,31,11,10,3170,3201
YBL105C,15,11,11,3426,3441
YKR060W,32,3,1,589,621
YKR060W,23,3,2,633,656
YKR060W,50,3,3,722,772
YKR048C,51,3,1,252,303
YKR048C,50,3,2,865,915
YKR048C,70,3,3,1044,1114
YGR232W,18,1,1,218,236
YEL066W,17,2,1,265,282
YEL066W,36,2,2,359,395
YEL046C,26,6,1,412,438
YEL046C,16,6,2,439,455
YEL046C,36,6,3,456,492
YEL046C,32,6,4,480,512
YEL046C,65,6,5,627,692
YEL046C,33,6,6,1099,1132
YBL055C,17,1,1,649,666
YPR035W,40,9,1,366,406
YPR035W,66,9,2,464,530
YPR035W,65,9,3,634,699
YPR035W,51,9,4,718,769
YPR035W,22,9,5,770,792
YPR035W,18,9,6,794,812
YPR035W,22,9,7,836,858
YPR035W,38,9,8,992,1030
YPR035W,16,9,9,1039,1055
YDL189W,49,4,1,257,306
YDL189W,20,4,2,383,403
YDL189W,36,4,3,955,991
YDL189W,25,4,4,1215,1240
YLL018C,38,10,1,618,656
YLL018C,63,10,2,846,909
YLL018C,32,10,3,910,942
YLL018C,75,10,4,984,1059
YLL018C,29,10,5,1050,1079
YLL018C,27,10,6,1273,1300
YLL018C,26,10,7,1336,1362
YLL018C,25,10,8,1370,1395
YLL018C,26,10,9,1434,1460
YLL018C,50,10,10,1470,1520
YDL130W-A,73,2,1,168,241
YDL130W-A,15,2,2,242,257
YML008C,43,5,1,266,309
YML008C,132,5,2,513,645
YML008C,17,5,3,652,669
YML008C,16,5,4,1071,1087
YML008C,36,5,5,1110,1146
YPR019W,23,16,1,456,479
YPR019W,77,16,2,1024,1101
YPR019W,28,16,3,1117,1145
YPR019W,26,16,4,1393,1419
YPR019W,27,16,5,1531,1558
YPR019W,20,16,6,1562,1582
YPR019W,41,16,7,1664,1705
YPR019W,63,16,8,1863,1926
YPR019W,18,16,9,1954,1972
YPR019W,44,16,10,2304,2348
YPR019W,19,16,11,2380,2399
YPR019W,48,16,12,2438,2486
YPR019W,15,16,13,2490,2505
YPR019W,17,16,14,2548,2565
YPR019W,29,16,15,2614,2643
YPR019W,26,16,16,2722,2748
YDR174W,35,2,1,154,189
YDR174W,40,2,2,411,451
YOR265W,20,2,1,178,198
YOR265W,36,2,2,245,281
YGL137W,111,10,1,188,299
YGL137W,18,10,2,308,326
YGL137W,89,10,3,313,402
YGL137W,153,10,4,434,587
YGL137W,16,10,5,636,652
YGL137W,42,10,6,755,797
YGL137W,32,10,7,799,831
YGL137W,35,10,8,1307,1342
YGL137W,69,10,9,1379,1448
YGL137W,55,10,10,2305,2360
YOR157C,45,5,1,317,362
YOR157C,38,5,2,368,406
YOR157C,39,5,3,431,470
YOR157C,20,5,4,671,691
YOR157C,18,5,5,761,779
YOR155C,26,5,1,291,317
YOR155C,28,5,2,658,686
YOR155C,20,5,3,1118,1138
YOR155C,33,5,4,1134,1167
YOR155C,35,5,5,1287,1322
YGL101W,18,1,1,443,461
YOR250C,17,4,1,1112,1129
YOR250C,42,4,2,1132,1174
YOR250C,28,4,3,1185,1213
YOR250C,46,4,4,1260,1306
YJR105W,118,3,1,491,609
YJR105W,33,3,2,739,772
YJR105W,74,3,3,944,1018
YPR042C,32,6,1,381,413
YPR042C,33,6,2,2013,2046
YPR042C,61,6,3,2081,2142
YPR042C,25,6,4,2249,2274
YPR042C,17,6,5,2277,2294
YPR042C,31,6,6,2446,2477
YCL009C,24,7,1,234,258
YCL009C,18,7,2,276,294
YCL009C,21,7,3,489,510
YCL009C,29,7,4,523,552
YCL009C,52,7,5,614,666
YCL009C,38,7,6,756,794
YCL009C,40,7,7,846,886
YDL005C,33,1,1,359,392
YHR113W,23,6,1,258,281
YHR113W,35,6,2,340,375
YHR113W,44,6,3,455,499
YHR113W,24,6,4,618,642
YHR113W,18,6,5,660,678
YHR113W,28,6,6,878,906
YER048W-A,22,1,1,256,278
YBR093C,36,1,1,407,443
YPR182W,32,1,1,229,261
YJL196C,19,2,1,180,199
YJL196C,42,2,2,374,416
YNL055C,25,3,1,530,555
YNL055C,68,3,2,661,729
YNL055C,105,3,3,744,849
YGL016W,25,11,1,409,434
YGL016W,29,11,2,539,568
YGL016W,53,11,3,560,613
YGL016W,27,11,4,857,884
YGL016W,26,11,5,1370,1396
YGL016W,38,11,6,1424,1462
YGL016W,23,11,7,1538,1561
YGL016W,28,11,8,1994,2022
YGL016W,23,11,9,2249,2272
YGL016W,22,11,10,3040,3062
YGL016W,18,11,11,3068,3086
YLR021W,55,1,1,471,526
YDR538W,47,1,1,461,508
YLR058C,42,6,1,412,454
YLR058C,170,6,2,619,789
YLR058C,36,6,3,936,972
YLR058C,36,6,4,1058,1094
YLR058C,34,6,5,1194,1228
YLR058C,29,6,6,1362,1391
YMR142C,54,4,1,177,231
YMR142C,65,4,2,321,386
YMR142C,52,4,3,412,464
YMR142C,37,4,4,468,505
YGR274C,31,7,1,835,866
YGR274C,30,7,2,1051,1081
YGR274C,17,7,3,1282,1299
YGR274C,23,7,4,1512,1535
YGR274C,48,7,5,2168,2216
YGR274C,17,7,6,2262,2279
YGR274C,16,7,7,2987,3003
YEL006W,23,4,1,326,349
YEL006W,27,4,2,361,388
YEL006W,19,4,3,418,437
YEL006W,30,4,4,491,521
YLR074C,21,1,1,175,196
YNL216W,27,2,1,613,640
YNL216W,50,2,2,848,898
YLR405W,47,7,1,293,340
YLR405W,69,7,2,344,413
YLR405W,15,7,3,472,487
YLR405W,16,7,4,561,577
YLR405W,23,7,5,586,609
YLR405W,21,7,6,606,627
YLR405W,35,7,7,641,676
YPL225W,31,4,1,195,226
YPL225W,40,4,2,220,260
YPL225W,42,4,3,328,370
YPL225W,24,4,4,374,398
YPL270W,29,3,1,203,232
YPL270W,53,3,2,234,287
YPL270W,46,3,3,300,346
YPL249C,46,4,1,1589,1635
YPL249C,20,4,2,1878,1898
YPL249C,28,4,3,2069,2097
YPL249C,40,4,4,2101,2141
YPR148C,35,4,1,445,480
YPR148C,33,4,2,686,719
YPR148C,46,4,3,848,894
YPR148C,102,4,4,970,1072
YBR015C,21,2,1,227,248
YBR015C,33,2,2,235,268
YER031C,16,2,1,227,243
YER031C,49,2,2,527,576
YJR006W,18,7,1,188,206
YJR006W,31,7,2,195,226
YJR006W,25,7,3,253,278
YJR006W,23,7,4,535,558
YJR006W,53,7,5,1144,1197
YJR006W,20,7,6,1223,1243
YJR006W,34,7,7,1234,1268
YGL187C,22,1,1,210,232
YJL177W,53,3,1,318,371
YJL177W,35,3,2,381,416
YJL177W,62,3,3,445,507
YLL013C,41,2,1,1160,1201
YLL013C,26,2,2,2333,2359
YLR430W,21,10,1,249,270
YLR430W,29,10,2,515,544
YLR430W,19,10,3,567,586
YLR430W,30,10,4,745,775
YLR430W,20,10,5,1583,1603
YLR430W,33,10,6,3865,3898
YLR430W,19,10,7,3961,3980
YLR430W,16,10,8,3981,3997
YLR430W,17,10,9,5559,5576
YLR430W,16,10,10,5904,5920
YOR108W,20,6,1,254,274
YOR108W,19,6,2,351,370
YOR108W,33,6,3,518,551
YOR108W,62,6,4,576,638
YOR108W,20,6,5,686,706
YOR108W,17,6,6,802,819
YJL068C,23,1,1,870,893
YJL117W,32,1,1,330,362
YNL054W,23,1,1,2763,2786
YGR210C,34,5,1,317,351
YGR210C,46,5,2,841,887
YGR210C,42,5,3,898,940
YGR210C,34,5,4,993,1027
YGR210C,68,5,5,1032,1100
YMR130W,19,1,1,260,279
YHR179W,22,7,1,290,312
YHR179W,16,7,2,328,344
YHR179W,34,7,3,418,452
YHR179W,52,7,4,456,508
YHR179W,78,7,5,623,701
YHR179W,72,7,6,769,841
YHR179W,66,7,7,983,1049
YOR117W,45,6,1,245,290
YOR117W,47,6,2,612,659
YOR117W,33,6,3,918,951
YOR117W,33,6,4,1094,1127
YOR117W,41,6,5,1145,1186
YOR117W,24,6,6,1220,1244
YNL049C,47,15,1,565,612
YNL049C,15,15,2,614,629
YNL049C,35,15,3,636,671
YNL049C,17,15,4,676,693
YNL049C,38,15,5,687,725
YNL049C,18,15,6,782,800
YNL049C,37,15,7,810,847
YNL049C,26,15,8,1731,1757
YNL049C,41,15,9,1758,1799
YNL049C,49,15,10,1852,1901
YNL049C,18,15,11,1975,1993
YNL049C,30,15,12,2082,2112
YNL049C,27,15,13,2117,2144
YNL049C,19,15,14,2240,2259
YNL049C,33,15,15,2249,2282
YGL195W,28,18,1,338,366
YGL195W,16,18,2,445,461
YGL195W,36,18,3,932,968
YGL195W,20,18,4,987,1007
YGL195W,44,18,5,1375,1419
YGL195W,15,18,6,2777,2792
YGL195W,36,18,7,2795,2831
YGL195W,55,18,8,3674,3729
YGL195W,20,18,9,4205,4225
YGL195W,33,18,10,4552,4585
YGL195W,39,18,11,4906,4945
YGL195W,26,18,12,6021,6047
YGL195W,15,18,13,6688,6703
YGL195W,15,18,14,6992,7007
YGL195W,62,18,15,7001,7063
YGL195W,26,18,16,7751,7777
YGL195W,24,18,17,7787,7811
YGL195W,20,18,18,7837,7857
YKL172W,59,1,1,752,811
YKR025W,27,2,1,665,692
YKR025W,31,2,2,788,819
YBR271W,15,2,1,794,809
YBR271W,29,2,2,896,925
YMR290C,140,4,1,337,477
YMR290C,21,4,2,482,503
YMR290C,19,4,3,741,760
YMR290C,38,4,4,1025,1063
YDR305C,19,2,1,217,236
YDR305C,16,2,2,503,519
YJR059W,26,2,1,1591,1617
YJR059W,17,2,2,1625,1642
YPR100W,55,4,1,221,276
YPR100W,26,4,2,283,309
YPR100W,29,4,3,304,333
YPR100W,20,4,4,383,403
YLR206W,16,5,1,218,234
YLR206W,28,5,2,438,466
YLR206W,44,5,3,506,550
YLR206W,31,5,4,648,679
YLR206W,18,5,5,1622,1640
YER088C,25,2,1,452,477
YER088C,17,2,2,1741,1758
YDR358W,32,4,1,233,265
YDR358W,18,4,2,268,286
YDR358W,33,4,3,673,706
YDR358W,30,4,4,1530,1560
YDR508C,39,3,1,225,264
YDR508C,62,3,2,584,646
YDR508C,17,3,3,668,685
YML025C,34,4,1,255,289
YML025C,16,4,2,315,331
YML025C,25,4,3,377,402
YML025C,22,4,4,557,579
YLR096W,20,12,1,272,292
YLR096W,36,12,2,602,638
YLR096W,26,12,3,688,714
YLR096W,21,12,4,993,1014
YLR096W,36,12,5,1022,1058
YLR096W,34,12,6,1072,1106
YLR096W,18,12,7,1197,1215
YLR096W,30,12,8,1219,1249
YLR096W,31,12,9,1240,1271
YLR096W,24,12,10,2230,2254
YLR096W,22,12,11,2524,2546
YLR096W,27,12,12,3024,3051
YKR052C,27,3,1,447,474
YKR052C,22,3,2,639,661
YKR052C,27,3,3,669,696
YMR047C,77,9,1,473,550
YMR047C,32,9,2,551,583
YMR047C,31,9,3,596,627
YMR047C,37,9,4,2441,2478
YMR047C,16,9,5,2488,2504
YMR047C,17,9,6,2506,2523
YMR047C,18,9,7,2526,2544
YMR047C,27,9,8,2558,2585
YMR047C,41,9,9,3090,3131
YMR147W,19,2,1,504,523
YMR147W,26,2,2,536,562
YLR068W,34,1,1,221,255
YDL141W,25,7,1,237,262
YDL141W,39,7,2,317,356
YDL141W,29,7,3,343,372
YDL141W,22,7,4,369,391
YDL141W,18,7,5,809,827
YDL141W,15,7,6,1629,1644
YDL141W,50,7,7,1647,1697
YLR100W,31,4,1,277,308
YLR100W,25,4,2,406,431
YLR100W,76,4,3,500,576
YLR100W,21,4,4,824,845
YML055W,36,2,1,243,279
YML055W,20,2,2,300,320
YML088W,21,4,1,427,448
YML088W,27,4,2,817,844
YML088W,20,4,3,851,871
YML088W,15,4,4,1253,1268
YPR175W,18,4,1,186,204
YPR175W,29,4,2,195,224
YPR175W,33,4,3,803,836
YPR175W,17,4,4,2006,2023
YLR116W,25,2,1,368,393
YLR116W,34,2,2,988,1022
YER008C,16,6,1,780,796
YER008C,19,6,2,2148,2167
YER008C,24,6,3,2170,2194
YER008C,33,6,4,2200,2233
YER008C,16,6,5,2387,2403
YER008C,21,6,6,2948,2969
YPL013C,28,2,1,158,186
YPL013C,90,2,2,276,366
YJR067C,65,2,1,206,271
YJR067C,43,2,2,373,416
YLR192C,30,3,1,608,638
YLR192C,57,3,2,659,716
YLR192C,31,3,3,762,793
YPL249C-A,22,1,1,280,302
YDR099W,28,1,1,385,413
YMR015C,31,1,1,1341,1372
YLR066W,19,2,1,468,487
YLR066W,31,2,2,474,505
YOR202W,38,1,1,169,207
YPR062W,24,1,1,440,464
YHR060W,25,1,1,406,431
YDR450W,23,2,1,237,260
YDR450W,41,2,2,265,306
YLR093C,55,1,1,293,348
YGL122C,28,1,1,1327,1355
YOR099W,32,1,1,372,404
YDR224C,22,1,1,372,394
YBR082C,29,1,1,388,417
YIL133C,29,1,1,343,372
YKL214C,21,1,1,234,255
YNL069C,28,1,1,489,517
YNL229C,21,1,1,918,939
YBR189W,33,1,1,287,320
YBR016W,27,1,1,191,218
YDL125C,25,2,1,207,232
YDL125C,32,2,2,304,336
YER027C,16,1,1,737,753
YER177W,15,1,1,646,661
YLR351C,23,1,1,361,384
YKR074W,22,1,1,273,295
YER030W,19,1,1,237,256
YLR179C,19,1,1,230,249
YNL263C,24,1,1,625,649
YGR060W,32,1,1,250,282
YLR344W,19,3,1,284,303
YLR344W,23,3,2,304,327
YLR344W,17,3,3,328,345
YLR287C-A,18,1,1,174,192
YNL002C,39,1,1,692,731
YOL039W,48,1,1,191,239
YLR264W,41,1,1,158,199
YNL036W,17,1,1,391,408
YOR115C,27,1,1,489,516
YLL050C,23,2,1,253,276
YLL050C,43,2,2,389,432
YMR173W,23,2,1,346,369
YMR173W,25,2,2,703,728
YAR028W,20,1,1,263,283
YCR061W,21,1,1,197,218
YER042W,15,1,1,265,280
YDR064W,37,2,1,196,233
YDR064W,36,2,2,242,278
YOR234C,35,1,1,271,306
YJR125C,16,1,1,250,266
YMR058W,17,1,1,333,350
YGR034W,31,1,1,316,347
YDL052C,15,1,1,825,840
YGL030W,66,1,1,227,293
YOR182C,18,1,1,174,192
YGR271C-A,18,1,1,400,418
YHR143W,21,1,1,284,305
YMR194W,31,2,1,199,230
YMR194W,16,2,2,286,302
YMR298W,17,1,1,328,345
YMR305C,15,1,1,312,327
YNL030W,21,1,1,290,311
YOL031C,17,1,1,314,331
YJR017C,21,1,1,247,268
YHR215W,41,1,1,401,442
YDL157C,15,1,1,222,237
YPR163C,87,1,1,573,660
YDR462W,32,1,1,387,419
YDL160C-A,15,1,1,216,231
YKR092C,23,1,1,205,228
YFL048C,18,1,1,784,802
YGL076C,57,1,1,389,446
YFR033C,30,1,1,177,207
YMR087W,17,1,1,755,772
YBR267W,47,1,1,824,871
YOR247W,20,1,1,537,557
YCL028W,19,1,1,586,605
YMR230W,29,1,1,287,316
YGR106C,48,1,1,534,582
YPR028W,23,1,1,240,263
YCL005W-A,23,1,1,195,218
